Parsing: "/home/frathoso/Dropbox/ASpring_2014/Capstone/atpg/benchmarks/s713.bench"...
Netlist file successfully parsed [ 0.0049 seconds ].

Input gates:
G1  G2  G3  G4  G5  G6  G8  G9  G10  G11  G12  G13  G14  G15  G16  G17  G18  G19  G20  G21  G22  G23  G24  G25  G26  G27  G28  G29  G30  G31  G32  G33  G34  G35  G36  G64  G65  G66  G67  G68  G69  G70  G71  G72  G73  G74  G75  G76  G77  G78  G79  G80  G81  G82  
Output gates:
G103BF  G104BF  G105BF  G106BF  G107  G83  G84  G85  G86BF  G87BF  G88BF  G89BF  G90  G91  G92  G94  G95BF  G96BF  G97BF  G98BF  G99BF  G100BF  G101BF  G380  G262  G394  G250  G122  G133  G138  G139  G140  G141  G142  G125  G126  G127  G128  G129  G130  G131  G132  

Total Lines: 447

Test Vectors:
Format: <Pattern/Input> <Results/Output> <# Faults> {<List of Faults>}

IIIIIOIIOOOOOIOIOIIIIIOIOOOOOIOIOIOOOOOOOOOIIOIOOOOOOO	XXXXXXXXXBXXBXXXXXXXXXXXXXXXXXXXBDXXXXXXXX	1	{ (G3, 0) }
IIOIIOIIOOOOOIOIOIIIIIOIOOOOOIOIOIOOOOOOOOOIIOIOOOOOOO	XXXXXXXXXDXXDXXXXXXXXXXXXXXXXXXXDBXXXXXXXX	1	{ (G3, 1) }
OIIIOOOOIOIOOOIOOIIIOOIIOOIOOIIIIIIIIOIOIOIIOIIOIIIOOI	XXXXXXXXXXXXBXXXXXXXXDXXXXXXBBXXXXXXXXXXXX	1	{ (G4, 0) }
OIIOOOOOIOIOOOIOOIIIOOIIOOIOOIIIIIIIIOIOIOIIOIIOIIIOOI	XXXXXXXXXXXXDXXXXXXXXBXXXXXXDDXXXXXXXXXXXX	1	{ (G4, 1) }
IIOIOIOIOIOOOIOOOIOOIIIIOOIIOOIOOIIIOIIIIIOOIOOIIOIIOI	XXXXXXXXXBXXBXXXXXXXXXXXXXXXXXXXBDXXXXXXXX	1	{ (G9, 0) }
IIOIOIOOOIOOOIOOOIOOIIIIOOIIOOIOOIIIOIIIIIOOIOOIIOIIOI	XXXXXXXXXDXXDXXXXXXXXXXXXXXXXXXXDBXXXXXXXX	1	{ (G9, 1) }
IIOIOIOOIIOOOIOOOIOOIIIIOOIIOOIOOIIIIIIIIIOOIOOIIOIIOI	XXXXXXXXXXBXBXXXXXXXXXXXXXXXXXXXBDXXXXXXXX	1	{ (G10, 0) }
IIOIOIOOOIOOOIOOOIOOIIIIOOIIOOIOOIIIIIIIIIOOIOOIIOIIOI	XXXXXXXXXXDXDXXXXXXXXXXXXXXXXXXXDBXXXXXXXX	1	{ (G10, 1) }
IIOIOIOIOIOOOIOOOIOOIIIIOOIIOOIOOIIIOIIIIOOIOOIIOIIOII	XXXXXXXXXBXXBXXXXXXXXXXXXXXXXXXXBDXXXXXXXX	1	{ (G11, 0) }
IIOIOOIIOOIOOIOIOIIOOIOIOIIIIOIIIOOIOIOIIIOIOOOOOIOIOO	XXXXXXXXXDXXDXXXXXXXXXXXXXXXXXXXDBXXXXXXXX	1	{ (G11, 1) }
OOIIIOIOOIIOIIOOOIOIIIIOIIIIOOIIOIIIIOOOOOIOIOOOOOOIII	XXXXXXXXXXXXDXXXXXXXXXXXXXXXXXXXXXXXXXXXXX	1	{ (G12, 0) }
OOIIIOIOOIOOIIOOOIOIIIIOIIIIOOIIOIIIIOOOOOIOIOOOOOOIII	XXXXXXXXXXXXBXXXXXXXXXXXXXXXXXXXXXXXXXXXXX	1	{ (G12, 1) }
IIOIOOIOOIIIOIOIOIIOOIOIOIIIIOIIIOOIOIOIIIOIOOOOOIOIOO	XXXXXXXXXBXXBXXXXXXXXXXXXXXXXXXXBDXXXXXXXX	1	{ (G13, 0) }
IIOIOOIOOIIOOIOIOIIOOIOIOIIIIOIIIOOIOIOIIIOIOOOOOIOIOO	XXXXXXXXXDXXDXXXXXXXXXXXXXXXXXXXDBXXXXXXXX	1	{ (G13, 1) }
OOIIOIOIOIIOOOIOIIIIOIIIOIOIIOIIIIOOOOOIOIOOOOOOIIIOIO	XXXXXXXXXXXXXDXXXXXXXXXXXXXXXXXXXXXXXXXXXX	1	{ (G27, 0) }
OOIIOIOIOIIOOOIOIIIIOIIIOOOIIOIIIIOOOOOIOIOOOOOOIIIOIO	XXXXXXXXXXXXXBXXXXXXXXXXXXXXXXXXXXXXXXXXXX	1	{ (G27, 1) }
OOIIOIOIOIIOOOIOIIIIOIIIOOIIIOIIIIOOOOOIOIOOOOOOIIIOIO	XXXXXXXXXXXXXXXDXXXXXXXXXXXXXXXXXXXXXXXXXX	1	{ (G29, 0) }
IIOIIIOOIOIIIIIIOOIIIIOOOIIOIOOOIIOIOIIOOOIOIIIOIIIOOO	XXXXXXXXXXXXXXXBXXXXXXXXXXXXXXXXXXXXXXXXXX	1	{ (G29, 1) }
IIOOIIIOOIOIIIIIIIOOIIIIOOOIIIOOOIIOIOIIOOOIOIIIOIIIIO	XXXXDXXXXXXXXXXXXXXXXXXXXXXXXXXXXXXXXXXXXX	1	{ (G107, 0) }
IIOIIIIOOIOIIIIIIIOOIIIIOOOIIIOOOIIOIOIIOOOIOIIIOIIIIO	XXXXBXXXXXXXXXXXXXXXXXXXXXXXXXXXXXXXXXXXXX	1	{ (G107, 1) }
IIOOIIIOOIOIIIIIIIOOIIIIOOOIIIOOOIIOIOIIOOOIOIIIOIIIIO	XXXXXDXXXXXXXXXXXXXXXXXXXXXXXXXXXXXXXXXXXX	1	{ (G83, 0) }
IIOIIIIOOIOIIIIIIIOOIIIIOOOIIIOOOIIOIOIIOOOIOIIIOIIIIO	XXXXXBXXXXXXXXXXXXXXXXXXXXXXXXXXXXXXXXXXXX	1	{ (G83, 1) }
IIOOIIIOOIOIIIIIIOIOIIIIOOOIIIOOOIIOIOIIOOOIOIIIOIIIIO	XXXXXXDXXXXXXXXXXXXXXXXXXXXXXXXXXXXXXXXXXX	1	{ (G84, 0) }
IIOIIIIOOIOIIIIIIOIOIIIIOOOIIIOOOIIOIOIIOOOIOIIIOIIIIO	XXXXXXBXXXXXXXXXXXXXXXXXXXXXXXXXXXXXXXXXXX	1	{ (G84, 1) }
OIOOOIIIOIOOIIOOOIOIIOIIOOIOOIOIOOOOOIIIIOOOIIOIIIOOOI	XXXXXXXDXXXXXXXXXXXXXXXXXXXXXXXXXXXXXXXXXX	1	{ (G85, 0) }
OIOIOIIIOIOOIIOOOIOIIOIIOOIOOIOIOOOOOIIIIOOOIIOIIIOOOI	XXXXXXXBXXXXXXXXXXXXXXXXXXXXXXXXXXXXXXXXXX	1	{ (G85, 1) }
OIOOIIIOIOOIIOOOIOIOIIOOIIOOIOIOOOOOIIIIOOOIIOIIIOOOII	XXXXXXXXXXXXXDXXXXXXXXXXXXXXXXXXXXXXXXXXXX	1	{ (G91, 0) }
OIOOIIIOIOOIIOOOIOIOIIOOIOOOIOIOOOOOIIIIOOOIIOIIIOOOII	XXXXXXXXXXXXXBXXXXXXXXXXXXXXXXXXXXXXXXXXXX	1	{ (G91, 1) }
OIOOIIIOIIIIOOIIOOOIOIOIIOIOIOOIOIOOOOOIIIIOOOIIOIIIOO	XXXXXXXXXXXXXXDXXXXXXXXXXXXXXXXXXXXXXXXXXX	1	{ (G92, 0) }
OIOOIIIOIOIIOOIIOOOIOIOIIOIOIOOIOIOOOOOIIIIOOOIIOIIIOO	XXXXXXXXXXXXXXBXXXXXXXXXXXXXXXXXXXXXXXXXXX	1	{ (G92, 1) }
OIOOIIIOIOOIIOOOIOIOIIOOIOOIIOIOOOOOIIIIOOOIIOIIIOOOII	XXXXXXXXXXXXXXXDXXXXXXXXXXXXXXXXXXXXXXXXXX	1	{ (G94, 0) }
OIOOIIIOIOOIIOOOIOIOIIOOIOOOIOIOOOOOIIIIOOOIIOIIIOOOII	XXXXXXXXXXXXXXXBXXXXXXXXXXXXXXXXXXXXXXXXXX	1	{ (G94, 1) }
OIOIOIIIOIOOIIOOOIOIOIIOOIOOIIOIOOOOOIIIIOOOIIIOIIIOOO	XXXXXXXXXXXXXXXXXDXXXXXXXXXXXXXXXXXXXXXXXX	1	{ (G96BF, 0) }
IIIOOOOOOIOIOIOIIOIOOIOOOOIOIIIIOOIOOIOOIIIIIOOIIOIOOI	XXXXXXXXXXXXXXXXXBXXXXXXXXXXXXXXXXXXXXXXXX	1	{ (G96BF, 1) }
IIIIOOOOOIOIOIOIIOIOOIOOOOIOIIIIOOIOOIOOIIIIIOOIIOIOOI	XXXXXXXXXXXXXXXXXXXDXXXXXXXXXXXXXXXXXXXXXX	1	{ (G98BF, 0) }
IIIOOOOOOIOIOIOIIOIOOIOOOOIOIIIIOOIOOIOOIIIIIOOIIOIOOI	XXXXXXXXXXXXXXXXXXXBXXXXXXXXXXXXXXXXXXXXXX	1	{ (G98BF, 1) }
IIIIOOOOOIOIOIOIIOIOOIOOOOIOIIIOOIIOOIOOIIIIIOOIIOIOOI	XXXXXXXXXXXXXXXXXXXXXDXXXXXXXXXXXXXXXXXXXX	1	{ (G100BF, 0) }
IIIOOOOOOIOIOIOIIOIOOIOOOOIOIIIOOIIOOIOOIIIIIOOIIOIOOI	XXXXXXXXXXXXXXXXXXXXXBXXXXXXXXXXXXXXXXXXXX	1	{ (G100BF, 1) }
IIIIOOOOOIOIOIOIIOIOOIIOOOOIOIIIOOIOIOIOOIIIIOOIIOIOOI	XXXXXXXXXDXXXXXXXXXXXXXXXXXXXXXXXXXXXXXXXX	1	{ (G65, 0) }
IIIIOOOOOIOIOIOIIOIOOIIOOOOIOIIIOOIOOOIOOIIIIOOIIOIOOI	XXXXXXXXXBXXXXXXXXXXXXXXXXXXXXXXXXXXXXXXXX	1	{ (G65, 1) }
IIIIOOOOOIOIOIOIIOIOOIOIOOOIOIIIOOIOOIIOOIIIIOOIIOIOOI	XXXXXXXXXXXDXXXXXXXXXXXXXXXXXXXXXXXXXXXXXX	1	{ (G67, 0) }
OOIIOIOIOOOIIOIIIIIOOOOIIIOIIIIOOIOOOIOOIOOOIOOIIOOOOI	XXXXXXXXXXXBXXXXXXXXXXXXXXXXXXXXXXXXXXXXXX	1	{ (G67, 1) }
OIOIIOIOOIIOOOOIIOIIIIIOOOOIIOIIIIIOOIOOIOIOIOOOIOOIIO	XXXXXXXXXXXXDXXXXXXXXBXXXXXXDDXXXXXXXXXXXX	1	{ (G69, 0) }
OIOIIOIOOIIOOOOIIOIIIIIOOOOIIOIIIIIOOIOOOOIOIOOOIOOIIO	XXXXXXXXXXXXBXXXXXXXXDXXXXXXBBXXXXXXXXXXXX	1	{ (G69, 1) }
OIOOIOIOOIOOOOIIOIIIIIOOOOIIOIIIIIOOIIOOOIIOIOOOIOOIIO	XXXXXXXXXXXXDXXXXXXBXXXXXXXXXXDDXXXXXXXXXX	1	{ (G71, 0) }
OIOOIOIOOIOOOOIIOIIIIIOOOOIIOIIIIIOOIIOOOIOOIOOOIOOIIO	XXXXXXXXXXXXBXXXXXXDXXXXXXXXXXBBXXXXXXXXXX	1	{ (G71, 1) }
OIOIIOIOOIIOOOOIIOIIIIIOOOOIIIOIIIIOOIOOOIOOIIOOOIOOII	XXXXXXXXXXXXDXXXXBXXXXXXXXXXXXXXDDXXXXXXXX	1	{ (G73, 0) }
OIOIIOIOOIIOOOOIIOIIIIIOOOOIIIOIIIIOOIOOOIOOOIOOOIOOII	XXXXXXXXXXXXBXXXXDXXXXXXXXXXXXXXBBXXXXXXXX	1	{ (G73, 1) }
OOIIOIOIOOOIIOIIIIIOOOOIIOIIIIOOIOOOIOIOOOIOOIIIOOOOIO	XXXXXXXXXXXXXXXXXXXXXXXDXXXXXXXXXXXXXXXXXX	1	{ (G75, 0) }
OOIIOIIOOIOOIIIOIIIIIOOOOIOIOIIOIIIIOIIOOOOIIIOOOOIIII	XXXXXXXXXXXXXXXXXXXXXXXBXXXXXXXXXXXXXXXXXX	1	{ (G75, 1) }
OOIIOIIOOIOOIIIOIIIIIOOOOIOIOIIOIIIIOIIOOOOIIIOOIOIIII	XXXXXXXXXXXXXXXXXXXXXXXXXDXXXXXXXXXXXXXXXX	1	{ (G77, 0) }
OOIIOIIOOIOOIIIOIIIIIOOOOIOIOIIOIIIIOIIOOOOIIIOOOOIIII	XXXXXXXXXXXXXXXXXXXXXXXXXBXXXXXXXXXXXXXXXX	1	{ (G77, 1) }
OOIOIOIIOOIOOIIIOIIIIIIOOOOIOIOIIOIIIIIOIIOOOOIIIIOOOI	XXXXXXXXXXBXXXXXXXXXXXXXXXXXXXXXXXXXXXXXXX	1	{ (G78, 0) }
OOIOIOIIOOIOOIIIOIIIIIIOOOOIOIOIIOIIIIIOIIOOOOIIIOOOOI	XXXXXXXXXXDXXXXXXXXXXXXXXXXXXXXXXXXXXXXXXX	1	{ (G78, 1) }
OOIOOIIOOIOOIIIOIIIIIIOOOOIOIOIIOIIIIOIIOOOOIIIOOOIIII	XXXXDXXXXXXXXXXXXXXXXXXXXXXXXXXXXXXXXXXXXX	1	{ (G79, 0) }
OOIOOIIOOIOOIIIOIIIIIIOOOOIOIOIIOIIIIOIIOOOOIIIOOOOIII	XXXXBXXXXXXXXXXXXXXXXXXXXXXXXXXXXXXXXXXXXX	1	{ (G79, 1) }
OOIOOIIOOIOOIIIOIIIIIIOOOOIOIOIIOIIIIOIIOOOOIIIOOOIIII	XXXXXDXXXXXXXXXXXXXXXXXXXXXXXXXXXXXXXXXXXX	1	{ (G80, 0) }
OOIOOIIOOIOOIIIOIIIIIIOOOOIOIOIIOIIIIOIIOOOOIIIOOOIOII	XXXXXBXXXXXXXXXXXXXXXXXXXXXXXXXXXXXXXXXXXX	1	{ (G80, 1) }
IOIOIOOOOIIIOIIIOOIOOOIOIOIOIOIIIIIOOIOOIOIOOOIOOOOIIO	XXXXXXDXXXXXXXXXXXXXXXXXXXXXXXXXXXXXXXXXXX	1	{ (G81, 0) }
IOIOIOOOOIIIOIIIOOIOOOIOIOIOIOIIIIIOOIOOIOIOOOIOOOOIOO	XXXXXXBXXXXXXXXXXXXXXXXXXXXXXXXXXXXXXXXXXX	1	{ (G81, 1) }
IOIOIOOOOIIIOIIIOOOIOOIOIOIOIOIIIIIOOIOOIOIOOOIOOOOIOI	XXXXXXXDXXXXXXXXXXXXXXXXXXXXXXXXXXXXXXXXXX	1	{ (G82, 0) }
IOIOIOOOOIIIOIIIOOOIOOIOIOIOIOIIIIIOOIOOIOIOOOIOOOOIOO	XXXXXXXBXXXXXXXXXXXXXXXXXXXXXXXXXXXXXXXXXX	1	{ (G82, 1) }
IIOIIIOIOOIOIOOOOIIIOIIIIOOOOOIOIOIOOIOIIIOIIOOIOOOIOI	XXXXXXXXXDXXDXXXXXXXXXXXXXXXXXXXDBXXXXXXXX	1	{ (G379, 0) }
IIIIIIOIOOIOIOOOOIIIOIIIIOOOOOIOIOIOOIOIIIOIIOOIOOOIOI	XXXXXXXXXBXXBXXXXXXXXXXXXXXXXXXXBDXXXXXXXX	1	{ (G379, 1) }
IIOOIIOOOOIOOIIIOIIIOOOOOIOIOIOIOIIIIIIOIOIOOIOIOOOIOO	XXXXXXXXXXXXDXXXXXXXXBXXXXXXDDXXXXXXXXXXXX	1	{ (I643, 0) }
IIOIIIOOOOIOOIIIOIIIOOOOOIOIOIOIOIIIIIIOIOIOOIOIOOOIOO	XXXXXXXXXXXXBXXXXXXXXDXXXXXXBBXXXXXXXXXXXX	1	{ (I643, 1) }
IIOIIOIOOIIOOOOOIIIOIIIIOOOOOIOIOIOIOOIIIIOIIOOIOOIOIO	XXXXXXXXXDXXDXXXXXXXXXXXXXXXXXXXDBXXXXXXXX	1	{ (I655, 0) }
IIOIIOIIOIIOOOOOIIIOIIIIOOOOOIOIOIOIOOIIIIOIIOOIOOIOIO	XXXXXXXXXBXXBXXXXXXXXXXXXXXXXXXXBDXXXXXXXX	1	{ (I655, 1) }
IIOIOOOOOIIOOOIIIIOOIIIIIIOOIIOIOIOIIOIOOIOOOIIOIIIIOI	XXXXXXXXXXDXDXXXXXXXXXXXXXXXXXXXDBXXXXXXXX	1	{ (I660, 0) }
IIOIOOOOIIIOOOIIIIOOIIIIIIOOIIOIOIOIIOIOOIOOOIIOIIIIOI	XXXXXXXXXXBXBXXXXXXXXXXXXXXXXXXXBDXXXXXXXX	1	{ (I660, 1) }
IIOIOOOIOOIOOOIIIIOOIIIIIIOOIIOIOIOIOOOOIOOOIIOIIIIOII	XXXXXXXXXDXXDXXXXXXXXXXXXXXXXXXXDBXXXXXXXX	1	{ (I680, 0) }
IIOIOOOIOIIOOOIIIIOOIIIIIIOOIIOIOIOIOOOOIOOOIIOIIIIOII	XXXXXXXXXBXXBXXXXXXXXXXXXXXXXXXXBDXXXXXXXX	1	{ (I680, 1) }
OOOIIOOOIIOIIOOIIIIIOOIIIOIOIOIOOOIOOIIOIIIIOIIOOOIIOI	XXXXXXXXXXXXBXXXXXXXXXXXXXXXXXXXXXXXXXXXXX	1	{ (I684, 0) }
OOOIIOOOIIIIIOOIIIIIOOIIIOIOIOIOOOIOOIIOIIIIOIIOOOIIOI	XXXXXXXXXXXXDXXXXXXXXXXXXXXXXXXXXXXXXXXXXX	1	{ (I684, 1) }
IIOIOOOOOIIOOOIIIIOOIIIIIIOOIIOIOIOIOOOOIOOOIIOIIIIOII	XXXXXXXXXDXXDXXXXXXXXXXXXXXXXXXXDBXXXXXXXX	1	{ (I687, 0) }
IIOIOOOOOIIIOOIIIIOOIIIIIIOOIIOIOIOIOOOOIOOOIIOIIIIOII	XXXXXXXXXBXXBXXXXXXXXXXXXXXXXXXXBDXXXXXXXX	1	{ (I687, 1) }
OOOIOOIIIIOOIIIIIOOIIOIOIOOIOOOIOOIIOIIIIOIIOOOIIOIOOO	XXXXXXXXXXXXXBXXXXXXXXXXXXXXXXXXXXXXXXXXXX	1	{ (I165, 0) }
IOOIOIIOIOOIIIOIOIOIIOOIIIIIOOOOIIOIIOOOIOOOOIOIIIIOOO	XXXXXXXXXXXXXDXXXXXXXXXXXXXXXXXXXXXXXXXXXX	1	{ (I165, 1) }
IOOIOIIOIOOIIIOIOIOIIOOIIIIOOOOOIIOIIOOOIOOOOIOIIIIOOO	XXXXXXXXXXXXXXXBXXXXXXXXXXXXXXXXXXXXXXXXXX	1	{ (II178, 0) }
IOOIOIIOIOOIIIOIOIOIIOOIIIIIOOOOIIOIIOOOIOOOOIOIIIIOOO	XXXXXXXXXXXXXXXDXXXXXXXXXXXXXXXXXXXXXXXXXX	1	{ (II178, 1) }
IIOOOIOIOIOOIOOIIIOIOIOIIOOIIIIIOOOOIIIOIIOOOOIOOOOIOI	XXXXXXXXXXXXBXXXXXXDXXXXXXXXXXBBXXXXXXXXXX	1	{ (I172, 0) }
IIOOOIOIOIOOIOOIIIOIOIOIIOOIIIIIOOOOIIIOIIIOOOIOOOOIOI	XXXXXXXXXXXXDXXXXXXBXXXXXXXXXXDDXXXXXXXXXX	1	{ (I172, 1) }
IIOOOIOIOIOOIOOIIIOIOIOIIOOIIIIIOOOOIIIOIIIOOOIOOOOIOI	XXXXXXXXXXXXDXXXXXXBXXXXXXXXXXDDXXXXXXXXXX	1	{ (G115, 0) }
IIOOOIOIOIOOIOOIIIOIOIOIIOOIIIIIOOOOIIIOIIOOOOIOOOOIOI	XXXXXXXXXXXXBXXXXXXDXXXXXXXXXXBBXXXXXXXXXX	1	{ (G115, 1) }
IOOOIOIIOIOOIIIOIIOIOIIOOIIIIOOOOIIOIIOOOIOOOOIOIIIOIO	XXXXXBXXXXXXXXXXXXXXXXXXXXXXXXXXXXXXXXXXXX	1	{ (I178, 0) }
IOOOIOIIOIOOIIIOIIOIOIIOOIIIIOOOOIIOIIOOOIOOOOIOIIIIIO	XXXXXDXXXXXXXXXXXXXXXXXXXXXXXXXXXXXXXXXXXX	1	{ (I178, 1) }
OOOOIOOIOIIIIOIOOIOIIIOOOOIOIOIOOIOOOOIOOOIIIIOIOOOIII	XXXXXDXXXXXXXXXXXXXXXXXXXXXXXXXXXXXXXXXXXX	1	{ (G219, 0) }
OOOOIOOIOIIIIOIOOIOIIIOOOOIOIOIOOIOOOOIOOOIIIIOIOOOOII	XXXXXBXXXXXXXXXXXXXXXXXXXXXXXXXXXXXXXXXXXX	1	{ (G219, 1) }
OIOIOIOOOIIOOIIIIOIOOOIIIOOOOIIOIOIOOIOOOOOIOOOOIIIIOI	XXXXXXXXXXXXBXXXXDXXXXXXXXXXXXXXBBXXXXXXXX	1	{ (I181, 0) }
OIOIOIOOOIIOOIIIIOIOOOIIIOOOOIIOIOIOOIOOOOOIIOOOIIIIOI	XXXXXXXXXXXXDXXXXBXXXXXXXXXXXXXXDDXXXXXXXX	1	{ (I181, 1) }
OIOIOIOOOIIOOIIIIOIOOOIIIOOOOIIOIOIOOIOOOOOIIOOOIIIIOI	XXXXXXXXXXXXDXXXXBXXXXXXXXXXXXXXDDXXXXXXXX	1	{ (G119, 0) }
OIOIOIOOOIIOOIIIIOIOOOIIIOOOOIIOIOIOOIOOOOOIOOOOIIIIOI	XXXXXXXXXXXXBXXXXDXXXXXXXXXXXXXXBBXXXXXXXX	1	{ (G119, 1) }
OOOOIOOIOIIIIOIOOOIIIIOOOOIOIOIOOIOOOOIOOOIIIIOIOOOIOI	XXXXXXBXXXXXXXXXXXXXXXXXXXXXXXXXXXXXXXXXXX	1	{ (I184, 0) }
OOOOIOOIOIIIIOIOOOIIIIOOOOIOIOIOOIOOOOIOOOIIIIOIOOOIII	XXXXXXDXXXXXXXXXXXXXXXXXXXXXXXXXXXXXXXXXXX	1	{ (I184, 1) }
OOOOIOOIOIIIIOIOOOIIIIOOOOIOIOIOOIOOOOIOOOIIIIOIOOOIII	XXXXXXDXXXXXXXXXXXXXXXXXXXXXXXXXXXXXXXXXXX	1	{ (G221, 0) }
OOOOIOOIOIIIIOIOOOIIIIOOOOIOIOIOOIOOOOIOOOIIIIOIOOOIOI	XXXXXXBXXXXXXXXXXXXXXXXXXXXXXXXXXXXXXXXXXX	1	{ (G221, 1) }
IIIOOOIIIOOIIOIOIIOIIIOOOIIOOOIOIOOOIOOOIOOOIOOIIIIOOO	XXXXXXXBXXXXXXXXXXXXXXXXXXXXXXXXXXXXXXXXXX	1	{ (I190, 0) }
IIIOOOIIIOOIIOIOIIOIIIOOOIIOOOIOIOOOIOOOIOOOIOOIIIIOOI	XXXXXXXDXXXXXXXXXXXXXXXXXXXXXXXXXXXXXXXXXX	1	{ (I190, 1) }
IIIOOOIIIOOIIOIOIIOIIIOOOIIOOOIOIOOOIOOOIOOOIOOIIIIOOI	XXXXXXXDXXXXXXXXXXXXXXXXXXXXXXXXXXXXXXXXXX	1	{ (G223, 0) }
IIIOOOIIIOOIIOIOIIOIIIOOOIIOOOIOIOOOIOOOIOOOIOOIIIIOOO	XXXXXXXBXXXXXXXXXXXXXXXXXXXXXXXXXXXXXXXXXX	1	{ (G223, 1) }
IIIIOOIIIOOIIOIOIIOIIOOOIIOOOIOIOOOIOOOIOOOIOOOIIIIOOI	XXXXXXXXXXXXXXXXXXXXXXXBXXXXXXXXXXXXXXXXXX	1	{ (I193, 0) }
IIIIOOIIIOOIIOIOIIOIIOOOIIOOOIOIOOOIOOOIOOOIOOIIIIIOOI	XXXXXXXXXXXXXXXXXXXXXXXDXXXXXXXXXXXXXXXXXX	1	{ (I193, 1) }
IIIIOOIIIOOIIOIOIIOIIOOOIIOOOIOIOOOIOOOIOOOIOOIIIIIOOI	XXXXXXXXXXXXXXXXXXXXXXXDXXXXXXXXXXXXXXXXXX	1	{ (G209, 0) }
IIIIOOIIIOOIIOIOIIOIIOOOIIOOOIOIOOOIOOOIOOOIOOOIIIIOOI	XXXXXXXXXXXXXXXXXXXXXXXBXXXXXXXXXXXXXXXXXX	1	{ (G209, 1) }
IIIIIOOOIIIOIOOIIOIOIIOIIOOOIIOOOIIOIOOOOIOOOIOOOIOOII	XXXXXXXXXXXXBXXXXXXXXDXXXXXXBBXXXXXXXXXXXX	1	{ (I202, 0) }
OIOIIOIOIIIOIOIIOIIIOOOIOOOIOOOOIIIIIIOOIIIIOOOIIOOIOO	XXXXXXXXXXXXDXXXXXXXXBXXXXXXDDXXXXXXXXXXXX	1	{ (I202, 1) }
OIOIIOIOIIIOIOIIOIIIOOOIOOOIOOOOIIIIIIOOIIIIOOOIIOOIOO	XXXXXXXXXXXXDXXXXXXXXBXXXXXXDDXXXXXXXXXXXX	1	{ (G111, 0) }
OIOIIOIOIIIOIOIIOIIIOOOIOOOIOOOOIIIIIIOOOIIIOOOIIOOIOO	XXXXXXXXXXXXBXXXXXXXXDXXXXXXBBXXXXXXXXXXXX	1	{ (G111, 1) }
OOIIOIIIIOIIOIIIOOOIOOOIOOOOIIIIIOOIIIOOOIIOOIOOOIOOIO	XXXXXXXXXXXXXXXXXXXXXXXXXBXXXXXXXXXXXXXXXX	1	{ (I205, 0) }
OOIIOIIIIOIIOIIIOOOIOOOIOOOOIIIIIOOIIIOOOIIOOIOOIIOOIO	XXXXXXXXXXXXXXXXXXXXXXXXXDXXXXXXXXXXXXXXXX	1	{ (I205, 1) }
OOIIOIIIIOIIOIIIOOOIOOOIOOOOIIIIIOOIIIOOOIIOOIOOIIOOIO	XXXXXXXXXXXXXXXXXXXXXXXXXDXXXXXXXXXXXXXXXX	1	{ (G213, 0) }
OOIIOIIIIOIIOIIIOOOIOOOIOOOOIIIIIOOIIIOOOIIOOIOOOIOOIO	XXXXXXXXXXXXXXXXXXXXXXXXXBXXXXXXXXXXXXXXXX	1	{ (G213, 1) }
OOIOIOIIIIOIIOIIIOOOIOIOOIOOOOIIIIIOOIIIIOOOIIOOIOOOIO	XXXXXXXXXXDXXXXXXXXXXXXXXXXXXXXXXXXXXXXXXX	1	{ (I208, 0) }
OOIOIOIIIIOIIOIIIOOOIOIOOIOOOOIIIIIOOIIIIOOOIIOOIIOOIO	XXXXXXXXXXBXXXXXXXXXXXXXXXXXXXXXXXXXXXXXXX	1	{ (I208, 1) }
OOIOIOIIIIOIIOIIIOOOIOIOOIOOOOIIIIIOOIIIIOOOIIOOIIOOIO	XXXXXXXXXXBXXXXXXXXXXXXXXXXXXXXXXXXXXXXXXX	1	{ (G215, 0) }
OOIIOOOOIOOIIOOIIIIIOOIOOOOIOOOIOOIIOIOOIIOIOIIOOOIOIO	XXXXXXXXXXDXXXXXXXXXXXXXXXXXXXXXXXXXXXXXXX	1	{ (G215, 1) }
OIOOOOOIOOIIOOIIIIIIOOOOOOIOOOIOOIIOOOIIOIOIIOOIOIOOOI	XXXXBXXXXXXXXXXXXXXXXXXXXXXXXXXXXXXXXXXXXX	1	{ (I211, 0) }
OIOOOOOIOOIIOOIIIIIIOOOOOOIOOOIOOIIOOOIIOIOIIOOIOIIOOI	XXXXDXXXXXXXXXXXXXXXXXXXXXXXXXXXXXXXXXXXXX	1	{ (I211, 1) }
OIOOOOOIOOIIOOIIIIIIOOOOOOIOOOIOOIIOOOIIOIOIIOOIOIIOOI	XXXXDXXXXXXXXXXXXXXXXXXXXXXXXXXXXXXXXXXXXX	1	{ (G217, 0) }
OIOOOOOIOOIIOOIIIIIIOOOOOOIOOOIOOIIOOOIIOIOIIOOIOIOOOI	XXXXBXXXXXXXXXXXXXXXXXXXXXXXXXXXXXXXXXXXXX	1	{ (G217, 1) }
OIIIOOOOOIIOOOIIOOIIIIIOOOOOOIOOOIIOOIIOIOOIIOIOIIOOIO	XXXXXXXXXXXXBXXXXXXXXDXXXXXXBBXXXXXXXXXXXX	1	{ (G360, 0) }
OIIOOOOOOIIOOOIIOOIIIIIOOOOOOIOOOIIOOIIOIOOIIOIOIIOOIO	XXXXXXXXXXXXDXXXXXXXXBXXXXXXDDXXXXXXXXXXXX	1	{ (G360, 1) }
IIOIOIOIOIOOOOIOOIIOOIIIIIIOOOOOOIOOOOIIOOOIIOOOIIOIOI	XXXXXXXXXBXXBXXXXXXXXXXXXXXXXXXXBDXXXXXXXX	1	{ (G364, 0) }
IIOIOIOOOIOOOOIOOIIOOIIIIIIOOOOOOIOOOOIIOOOIIOOOIIOIOI	XXXXXXXXXDXXDXXXXXXXXXXXXXXXXXXXDBXXXXXXXX	1	{ (G364, 1) }
IIOIOIOOIIOOOOIOOIIOOIIIIIIOOOOOOIOOIOIIOOOIIOOOIIOIOI	XXXXXXXXXXBXBXXXXXXXXXXXXXXXXXXXBDXXXXXXXX	1	{ (G367, 0) }
IIOIIOIOOIOOOIOOOOOIIIIOIOOOIIOOOIIOIOIIIIOOIOIOOIOOIO	XXXXXXXXXXDXDXXXXXXXXXXXXXXXXXXXDBXXXXXXXX	1	{ (G367, 1) }
IIOIIOIIOIOOOIOOOOOIIIIOIOOOIIOOOIIOOOIIIOOIOIOOIOOIOO	XXXXXXXXXBXXBXXXXXXXXXXXXXXXXXXXBDXXXXXXXX	1	{ (G386, 0) }
IIOIIOIIOOOOOIOOOOOIIIIOIOOOIIOOOIIOOOIIIOOIOIOOIOOIOO	XXXXXXXXXDXXDXXXXXXXXXXXXXXXXXXXDBXXXXXXXX	1	{ (G386, 1) }
IOIIOOIOOOIOOOIIIOIOOOIIIOOOIIOOIIIOIOIOOIOOIOOIIOOOOO	XXXXXXXXXXXXDXXXXXXXXXXXXXXXXXXXXXXXXXXXXX	1	{ (G388, 0) }
IOIIOOIOOOOOOOIIIOIOOOIIIOOOIIOOIIIOIOIOOIOOIOOIIOOOOO	XXXXXXXXXXXXBXXXXXXXXXXXXXXXXXXXXXXXXXXXXX	1	{ (G388, 1) }
IIOIIOIOOIOIOIOOOOOIIIIOIOOOIIOOOIIOOOIIIOOIOIOOIOOIOO	XXXXXXXXXBXXBXXXXXXXXXXXXXXXXXXXBDXXXXXXXX	1	{ (G389, 0) }
IIOIIOIOOIOOOIOOOOOIIIIOIOOOIIOOOIIOOOIIIOOIOIOOIOOIOO	XXXXXXXXXDXXDXXXXXXXXXXXXXXXXXXXDBXXXXXXXX	1	{ (G389, 1) }
IIOOIOOOIOIOOOOOIIIOIOOOIIOOOIIOOIIIIOIOIIOOIOOIOOIIOO	XXXXXXXXXXXXDXXXXXXXXBXXXXXXDDXXXXXXXXXXXX	1	{ (G110, 0) }
IIOIIOOOIOIOOOOOIIIOIOOOIIOOOIIOOIIIIOIOIIOOIOOIOOIIOO	XXXXXXXXXXXXBXXXXXXXXDXXXXXXBBXXXXXXXXXXXX	1	{ (G110, 1) }
IIOOIOOIOOOOOOOIIIOIOOOIIOOOIIOIOIIIIOIOIOIOIOOIOOIIOO	XXXXXXXXXXXXDXXXXXXBXXXXXXXXXXDDXXXXXXXXXX	1	{ (G114, 0) }
OIOIIIIIOIOOOOIOIIOOIIIIOOIIIOIIOIIOIIIIOOIIIOIOOIIIOI	XXXXXXXXXXXXBXXXXXXDXXXXXXXXXXBBXXXXXXXXXX	1	{ (G114, 1) }
OIOOIIIOIIIOOOOIOIIOOIIIIOOIIIIOIOIIOIIIOOOIIIOIOOIIIO	XXXXXXXXXXXXDXXXXBXXXXXXXXXXXXXXDDXXXXXXXX	1	{ (G118, 0) }
OIOIIIIOIIIOOOOIOIIOOIIIIOOIIIIOIOIIOIIIOOOIIIOIOOIIIO	XXXXXXXXXXXXBXXXXDXXXXXXXXXXXXXXBBXXXXXXXX	1	{ (G118, 1) }
OOIOIIIIOOOIOIIOIOIIIIOOIIIOIOIIOIIIOOIIOIOOIIIOIOIIOI	XXXXDXXXXXXXXXXXXXXXXXXXXXXXXXXXXXXXXXXXXX	1	{ (G216, 0) }
OOIIIIIIOOOIOIIOIOIIIIOOIIIOIOIIOIIIOOIIOIOOIIIOIOIIOI	XXXXBXXXXXXXXXXXXXXXXXXXXXXXXXXXXXXXXXXXXX	1	{ (G216, 1) }
OOIOIIIIOOOIOIIOOIIIIIOOIIIOIOIIOIIIOOIIOIOOIIIOIOIIOI	XXXXXDXXXXXXXXXXXXXXXXXXXXXXXXXXXXXXXXXXXX	1	{ (G218, 0) }
OOIIIIIIOOOIOIIOOIIIIIOOIIIOIOIIOIIIOOIIOIOOIIIOIOIIOI	XXXXXBXXXXXXXXXXXXXXXXXXXXXXXXXXXXXXXXXXXX	1	{ (G218, 1) }
OOIOIIIIOOOIOIIOOIIIIIOOIIIOIOIIOIIIOOIIOIOOIIIOIOIOII	XXXXXXDXXXXXXXXXXXXXXXXXXXXXXXXXXXXXXXXXXX	1	{ (G220, 0) }
OOIIIIIIOOOIOIIOOIIIIIOOIIIOIOIIOIIIOOIIOIOOIIIOIOIOII	XXXXXXBXXXXXXXXXXXXXXXXXXXXXXXXXXXXXXXXXXX	1	{ (G220, 1) }
OOIOIIIIOOOIOIIOOIIIIIOOIIIOIOIIOIIIOOIIOIOOIIIOIOIOII	XXXXXXXDXXXXXXXXXXXXXXXXXXXXXXXXXXXXXXXXXX	1	{ (G222, 0) }
OOIIIIIIOOOIOIIOOIIIIIOOIIIOIOIIOIIIOOIIOIOOIIIOIOIOII	XXXXXXXBXXXXXXXXXXXXXXXXXXXXXXXXXXXXXXXXXX	1	{ (G222, 1) }
IIOIIOIOOIOOIOIIIOOOOIIIIOIOIOOOOOIIOOIIIIOOIOOOOIIIII	XXXXXXXXXDXXDXXXXXXXXXXXXXXXXXXXDBXXXXXXXX	1	{ (G365, 0) }
IIOIIOIIOIOOIOIIIOOOOIIIIOIOIOOOOOIIOOIIIIOOIOOOOIIIII	XXXXXXXXXBXXBXXXXXXXXXXXXXXXXXXXBDXXXXXXXX	1	{ (G365, 1) }
IIOIIOIOOIOOIOIIIOOOOIIIIOIOIOOOOOIIIOIIIIOOIOOOOIIIII	XXXXXXXXXXDXDXXXXXXXXXXXXXXXXXXXDBXXXXXXXX	1	{ (G368, 0) }
IIOIIOIOIIOOIOIIIOOOOIIIIOIOIOOOOOIIIOIIIIOOIOOOOIIIII	XXXXXXXXXXBXBXXXXXXXXXXXXXXXXXXXBDXXXXXXXX	1	{ (G368, 1) }
IIOIIOIIOOOOIOIIIOOOOIIIIOIOIOOOOOIIOOIIIOOIOOOOIIIIIO	XXXXXXXXXDXXDXXXXXXXXXXXXXXXXXXXDBXXXXXXXX	1	{ (G387, 0) }
IIOIIOIIOIOOIOIIIOOOOIIIIOIOIOOOOOIIOOIIIOOIOOOOIIIIIO	XXXXXXXXXBXXBXXXXXXXXXXXXXXXXXXXBDXXXXXXXX	1	{ (G387, 1) }
IOIIOIOOIIOIOOOOIIIOIOIOIOOOOIIOIIIOIOOOOIIIIIOIOIIOOI	XXXXXXXXXXXXBXXXXXXXXXXXXXXXXXXXXXXXXXXXXX	1	{ (G225, 0) }
IOIIOIOOIIIIOOOOIIIOIOIOIOOOOIIOIIIOIOOOOIIIIIOIOIIOOI	XXXXXXXXXXXXDXXXXXXXXXXXXXXXXXXXXXXXXXXXXX	1	{ (G225, 1) }
IIOIIOIOOIOOIOIIIOOOOIIIIOIOIOOOOOIIOOIIIOOIOOOOIIIIIO	XXXXXXXXXDXXDXXXXXXXXXXXXXXXXXXXDBXXXXXXXX	1	{ (G390, 0) }
IIOIIOIOOIOIIOIIIOOOOIIIIOIOIOOOOOIIOOIIIOOIOOOOIIIIIO	XXXXXXXXXBXXBXXXXXXXXXXXXXXXXXXXBDXXXXXXXX	1	{ (G390, 1) }
IOOIIIIIOOIIIOOOOOIOIOOOOIIOIOIIOIOIIIOOOOOIIOIIIIOIOO	XXXXXXXXXXXXXXBXXXXXXXXXXXXXXXXXXXXXXXXXXX	1	{ (I356, 0) }
IOOIIIIIOIIIIOOOOOIOIOOOOIIOIOIIOIOIIIOOOOOIIOIIIIOIOO	XXXXXXXXXXXXXXDXXXXXXXXXXXXXXXXXXXXXXXXXXX	1	{ (I356, 1) }
IOOIIIIIOIIIIOOOOOIOIOOOOIIOIOIIOIOIIIOOOOOIIOIIIIOIOO	XXXXXXXXXXXXXXDXXXXXXXXXXXXXXXXXXXXXXXXXXX	1	{ (G289, 0) }
IOOIIIIIOOIIIOOOOOIOIOOOOIIOIOIIOIOIIIOOOOOIIOIIIIOIOO	XXXXXXXXXXXXXXBXXXXXXXXXXXXXXXXXXXXXXXXXXX	1	{ (G289, 1) }
IIOOOIIOIIIOIOIOOOOOIOIOOOOIOIOIIIOIOIIIIOOOOOIIOIIIIO	XXXXXXXXXXXXDXXXXXXXXBXXXXXXDDXXXXXXXXXXXX	1	{ (G324, 0) }
IIOIOIIOIIIOIOIOOOOOIOIOOOOIOIOIIIOIOIIIIOOOOOIIOIIIIO	XXXXXXXXXXXXBXXXXXXXXDXXXXXXBBXXXXXXXXXXXX	1	{ (G324, 1) }
IOOIIIIIIOIOOOOOIOIOOOOIOIOIIOIOIIIIOOOOIOIIOIIIIOIOOO	XXXXXXXXXXXXXXXXXXXXXDXXXXXXXXXXXXXXXXXXXX	1	{ (I257, 0) }
IOOOIIIIIOIOOOOOIOIOOOOIOIOIIOIOIIIIOOOOIOIIOIIIIOIOOO	XXXXXXXXXXXXXXXXXXXXXBXXXXXXXXXXXXXXXXXXXX	1	{ (I257, 1) }
IOOOIIIIIOIOOOOOIOIOOOOIOIOIIOIOIIIIOOOOIOIIOIIIIOIOOO	XXXXXXXXXXXXXXXXXXXXXBXXXXXXXXXXXXXXXXXXXX	1	{ (G325, 0) }
IOOIIIIIIOIOOOOOIOIOOOOIOIOIIOIOIIIIOOOOIOIIOIIIIOIOOO	XXXXXXXXXXXXXXXXXXXXXDXXXXXXXXXXXXXXXXXXXX	1	{ (G325, 1) }
IIOOIIIOOOIOOOOIIIIIIIOOOOOOIOIIOOOIIIOOIIIOIOOIOIOOII	XXXXXXXXXXXXDXXXXXXBXXXXXXXXXXDDXXXXXXXXXX	1	{ (G338, 0) }
IIOIIIIOOOIOOOOIIIIIIIOOOOOOIOIIOOOIIIOOIIIOIOOIOIOOII	XXXXXXXXXXXXBXXXXXXDXXXXXXXXXXBBXXXXXXXXXX	1	{ (G338, 1) }
IOIIIIOOIOOOIIIIIIIOOOOOOIOIOOOIIIOOIIOIOOIIOIOOIIIOOI	XXXXXXXXXXXXXXXXXXXDXXXXXXXXXXXXXXXXXXXXXX	1	{ (I263, 0) }
IOIOIIOOIOOOIIIIIIIOOOOOOIOIOOOIIIOOIIOIOOIIOIOOIIIOOI	XXXXXXXXXXXXXXXXXXXBXXXXXXXXXXXXXXXXXXXXXX	1	{ (I263, 1) }
IOIOIIOOIOOOIIIIIIIOOOOOOIOIOOOIIIOOIIOIOOIIOIOOIIIOOI	XXXXXXXXXXXXXXXXXXXBXXXXXXXXXXXXXXXXXXXXXX	1	{ (G339, 0) }
IOIIIIOOIOOOIIIIIIIOOOOOOIOIOOOIIIOOIIOIOOIIOIOOIIIOOI	XXXXXXXXXXXXXXXXXXXDXXXXXXXXXXXXXXXXXXXXXX	1	{ (G339, 1) }
IIOOIIIOOOIOIOOOIIIIIIIOOOOOOIIOIOOOIIOOIIOOIIOOIOIOOI	XXXXXXXXXXXXDXXXXBXXXXXXXXXXXXXXDDXXXXXXXX	1	{ (G344, 0) }
IIOIIIIOOOIOIOOOIIIIIIIOOOOOOIIOIOOOIIOOIIOOIIOOIOIOOI	XXXXXXXXXXXXBXXXXDXXXXXXXXXXXXXXBBXXXXXXXX	1	{ (G344, 1) }
IOIIIIOOIOOOIIIIIIIOOOOOOIOIOIOOIIOOIIOIOOIOIIOOIIIOOI	XXXXXXXXXXXXXXXXXDXXXXXXXXXXXXXXXXXXXXXXXX	1	{ (I269, 0) }
IOIOIIOOIOOOIIIIIIIOOOOOOIOIOIOOIIOOIIOIOOIOIIOOIIIOOI	XXXXXXXXXXXXXXXXXBXXXXXXXXXXXXXXXXXXXXXXXX	1	{ (I269, 1) }
IOIOIIOOIOOOIIIIIIIOOOOOOIOIOIOOIIOOIIOIOOIOIIOOIIIOOI	XXXXXXXXXXXXXXXXXBXXXXXXXXXXXXXXXXXXXXXXXX	1	{ (G345, 0) }
IOOIIIOOOIOOOIOIOIIOOOIOOOOOIIIIIOOIIIIOIIOIIIIIOIOIOI	XXXXXXXXXXXXXXXXXDXXXXXXXXXXXXXXXXXXXXXXXX	1	{ (G345, 1) }
IOOIIIOOOIOOOIOIIOIIOOOIOOOOOIIIIOOIIIIOIIOIIIIOIOIIOI	XXXXBXXXXXXXXXXXXXXXXXXXXXXXXXXXXXXXXXXXXX	1	{ (I272, 0) }
IOOOIIOOOIOOOIOIIOIIOOOIOOOOOIIIIOOIIIIOIIOIIIIOIOIIOI	XXXXDXXXXXXXXXXXXXXXXXXXXXXXXXXXXXXXXXXXXX	1	{ (I272, 1) }
IOOOIIOOOIOOOIOIIOIIOOOIOOOOOIIIIOOIIIIOIIOIIIIOIOIIOI	XXXXDXXXXXXXXXXXXXXXXXXXXXXXXXXXXXXXXXXXXX	1	{ (G312, 0) }
IOOIIIOOOIOOOIOIIOIIOOOIOOOOOIIIIOOIIIIOIIOIIIIOIOIIOI	XXXXBXXXXXXXXXXXXXXXXXXXXXXXXXXXXXXXXXXXXX	1	{ (G312, 1) }
IOOOIIOOOIOOOIOIIOIIOOOIOOOOOIIIIOOIIIIOIIOIIIIOIOIIOI	XXXXDXXXXXXXXXXXXXXXXXXXXXXXXXXXXXXXXXXXXX	1	{ (G313, 0) }
IOOIIIOOOIOOOIOIIOIIOOOIOOOOOIIIIOOIIIIOIIOIIIIOIOIIOI	XXXXBXXXXXXXXXXXXXXXXXXXXXXXXXXXXXXXXXXXXX	1	{ (G313, 1) }
IOOIIIOOOIOOOIOIOIIIOOOIOOOOOIIIIOOIIIIOIIOIIIIOIOIIOI	XXXXXBXXXXXXXXXXXXXXXXXXXXXXXXXXXXXXXXXXXX	1	{ (I275, 0) }
IOOOIIOOOIOOOIOIOIIIOOOIOOOOOIIIIOOIIIIOIIOIIIIOIOIIOI	XXXXXDXXXXXXXXXXXXXXXXXXXXXXXXXXXXXXXXXXXX	1	{ (I275, 1) }
IOOOIIOOOIOOOIOIOIIIOOOIOOOOOIIIIOOIIIIOIIOIIIIOIOIIOI	XXXXXDXXXXXXXXXXXXXXXXXXXXXXXXXXXXXXXXXXXX	1	{ (G315, 0) }
IOOIIIOOOIOOOIOIOIIIOOOIOOOOOIIIIOOIIIIOIIOIIIIOIOIIOI	XXXXXBXXXXXXXXXXXXXXXXXXXXXXXXXXXXXXXXXXXX	1	{ (G315, 1) }
IOOOIIOOOIOOOIOIOIIIOOOIOOOOOIIIIOOIIIIOIIOIIIIOIOIIOI	XXXXXDXXXXXXXXXXXXXXXXXXXXXXXXXXXXXXXXXXXX	1	{ (G316, 0) }
IIOIOOOOIIOIIIIOOIOIIOIIIOOOOOOIIOOOOOOIIIIIOOOOOOIIIO	XXXXXBXXXXXXXXXXXXXXXXXXXXXXXXXXXXXXXXXXXX	1	{ (G316, 1) }
IIOIOOOOIIOIIIIOOOIIIOIIIOOOOOOIIOOOOOOIIIIIOOOOOOIIIO	XXXXXXBXXXXXXXXXXXXXXXXXXXXXXXXXXXXXXXXXXX	1	{ (I278, 0) }
IIOOOOOOIIOIIIIOOOIIIOIIIOOOOOOIIOOOOOOIIIIIOOOOOOIIIO	XXXXXXDXXXXXXXXXXXXXXXXXXXXXXXXXXXXXXXXXXX	1	{ (I278, 1) }
IIOOOOOOIIOIIIIOOOIIIOIIIOOOOOOIIOOOOOOIIIIIOOOOOOIIIO	XXXXXXDXXXXXXXXXXXXXXXXXXXXXXXXXXXXXXXXXXX	1	{ (G318, 0) }
IIOIOOOOIIOIIIIOOOIIIOIIIOOOOOOIIOOOOOOIIIIIOOOOOOIIIO	XXXXXXBXXXXXXXXXXXXXXXXXXXXXXXXXXXXXXXXXXX	1	{ (G318, 1) }
IIOOOOOOIIOIIIIOOOIIIOIIIOOOOOOIIOOOOOOIIIIIOOOOOOIIIO	XXXXXXDXXXXXXXXXXXXXXXXXXXXXXXXXXXXXXXXXXX	1	{ (G319, 0) }
IIOIOOOOIIOIIIIOOOIIIOIIIOOOOOOIIOOOOOOIIIIIOOOOOOIIIO	XXXXXXBXXXXXXXXXXXXXXXXXXXXXXXXXXXXXXXXXXX	1	{ (G319, 1) }
IIOIOOOOIIOIIIIOOOIIIOIIIOOOOOOIIOOOOOOIIIIIOOOOOOIIOI	XXXXXXXBXXXXXXXXXXXXXXXXXXXXXXXXXXXXXXXXXX	1	{ (I281, 0) }
IIOOOOOOIIOIIIIOOOIIIOIIIOOOOOOIIOOOOOOIIIIIOOOOOOIIOI	XXXXXXXDXXXXXXXXXXXXXXXXXXXXXXXXXXXXXXXXXX	1	{ (I281, 1) }
IIOOOOOOIIOIIIIOOOIIIOIIIOOOOOOIIOOOOOOIIIIIOOOOOOIIOI	XXXXXXXDXXXXXXXXXXXXXXXXXXXXXXXXXXXXXXXXXX	1	{ (G321, 0) }
IIOIOOOOIIOIIIIOOOIIIOIIIOOOOOOIIOOOOOOIIIIIOOOOOOIIOI	XXXXXXXBXXXXXXXXXXXXXXXXXXXXXXXXXXXXXXXXXX	1	{ (G321, 1) }
OIIOIIOIOIIOOIIIOIIIOIOIOOIIIIIIIOOIIIIIIIOOIOIOOOIOII	XXXXXXXDXXXXXXXXXXXXXXXXXXXXXXXXXXXXXXXXXX	1	{ (G322, 0) }
OIIIIIOIOIIOOIIIOIIIOIOIOOIIIIIIIOOIIIIIIIOOIOIOOOIOII	XXXXXXXBXXXXXXXXXXXXXXXXXXXXXXXXXXXXXXXXXX	1	{ (G322, 1) }
OIIIIOIOIIIIIOOIIIOIIOIOIOIOIIIIIIIOOIIIIIIIOOIOIOOOIO	XXXXXXXXXXXXXXDXXXXXXXXXXXXXXXXXXXXXXXXXXX	1	{ (G143, 0) }
OIIIIOIOIOIIIOOIIIOIIOIOIOIOIIIIIIIOOIIIIIIIOOIOIOOOIO	XXXXXXXXXXXXXXBXXXXXXXXXXXXXXXXXXXXXXXXXXX	1	{ (G143, 1) }
OIIIIOIOIOIIIOOIIIOIIOIOIOIOIIIIIIIOOIIIIIIIOOIOIOOOIO	XXXXXXXXXXXXXXBXXXXXXXXXXXXXXXXXXXXXXXXXXX	1	{ (I303, 0) }
OIIIIOIOIIIIIOOIIIOIIOIOIOIOIIIIIIIOOIIIIIIIOOIOIOOOIO	XXXXXXXXXXXXXXDXXXXXXXXXXXXXXXXXXXXXXXXXXX	1	{ (I303, 1) }
OIIIIOIOIIIIIOOIIIOIIOIOIOIOIIIIIIIOOIIIIIIIOOIOIOOOIO	XXXXXXXXXXXXXXDXXXXXXXXXXXXXXXXXXXXXXXXXXX	1	{ (G350, 0) }
OIIIIOIOIOIIIOOIIIOIIOIOIOIOIIIIIIIOOIIIIIIIOOIOIOOOIO	XXXXXXXXXXXXXXBXXXXXXXXXXXXXXXXXXXXXXXXXXX	1	{ (G350, 1) }
OIIIIIOIIOOIIOOIIIOIIIOIOIOOIIIIIIIOOOIIIIIIIOOIOIOOOI	XXXXXXXXXBXXXXXXXXXXXXXXXXXXXXXXXXXXXXXXXX	1	{ (I299, 0) }
OIOIIIOIIOOIIOOIIIOIIIOIOIOOIIIIIIIOOOIIIIIIIOOIOIOOOI	XXXXXXXXXDXXXXXXXXXXXXXXXXXXXXXXXXXXXXXXXX	1	{ (I299, 1) }
OIOIIIOIIOOIIOOIIIOIIIOIOIOOIIIIIIIOOOIIIIIIIOOIOIOOOI	XXXXXXXXXDXXXXXXXXXXXXXXXXXXXXXXXXXXXXXXXX	1	{ (G281, 0) }
OIIIIIOIIOOIIOOIIIOIIIOIOIOOIIIIIIIOOOIIIIIIIOOIOIOOOI	XXXXXXXXXBXXXXXXXXXXXXXXXXXXXXXXXXXXXXXXXX	1	{ (G281, 1) }
IOIOOOOOOOOOIOOIOIIOIIOIOOOOOOOOIIOIIOOIIOIIOOOOOOIIIO	XXXXXXXXXXXBXXXXXXXXXXXXXXXXXXXXXXXXXXXXXX	1	{ (I313, 0) }
IOOOOOOOOOOOIOOIOIIOIIOIOOOOOOOOIIOIIOOIIOIIOOOOOOIIIO	XXXXXXXXXXXDXXXXXXXXXXXXXXXXXXXXXXXXXXXXXX	1	{ (I313, 1) }
IOOOOOOOOOOOIOOIOIIOIIOIOOOOOOOOIIOIIOOIIOIIOOOOOOIIIO	XXXXXXXXXXXDXXXXXXXXXXXXXXXXXXXXXXXXXXXXXX	1	{ (G283, 0) }
IOIOOOOOOOOOIOOIOIIOIIOIOOOOOOOOIIOIIOOIIOIIOOOOOOIIIO	XXXXXXXXXXXBXXXXXXXXXXXXXXXXXXXXXXXXXXXXXX	1	{ (G283, 1) }
IOOOOOOOOOIOOIOIIOIIOOOOOOOOOIIOIIIOIIOIIIOOOOOOIIIOOI	XXXXXXXXXXXXXXXXXXXXXBXXXXXXXXXXXXXXXXXXXX	1	{ (G100, 0) }
IOOIOOOOOOIOOIOIIOIIOOOOOOOOOIIOIIIOIIOIIIOOOOOOIIIOOI	XXXXXXXXXXXXXXXXXXXXXDXXXXXXXXXXXXXXXXXXXX	1	{ (G100, 1) }
IOOOOOOOOOIOOIOIIOIIOOOOOOOOOIIIOIIOIIOIIOIOOOOOIIIOOI	XXXXXXXXXXXXXXXXXXXBXXXXXXXXXXXXXXXXXXXXXX	1	{ (G98, 0) }
IOOIOOOOOOIOOIOIIOIIOOOOOOOOOIIIOIIOIIOIIOIOOOOOIIIOOI	XXXXXXXXXXXXXXXXXXXDXXXXXXXXXXXXXXXXXXXXXX	1	{ (G98, 1) }
IOOOOOOOOOIOOIOIIOIIOOOOOOOOOIIIOIIOIIOIIOOOIOOOIIIOOI	XXXXXXXXXXXXXXXXXBXXXXXXXXXXXXXXXXXXXXXXXX	1	{ (G96, 0) }
IOOIOOOOOOIOOIOIIOIIOOOOOOOOOIIIOIIOIIOIIOOOIOOOIIIOOI	XXXXXXXXXXXXXXXXXDXXXXXXXXXXXXXXXXXXXXXXXX	1	{ (G96, 1) }
IOOOOOOIOOOOIOOIOIIOIIIOOOOOOOOOIIOIOIOIIOIIOOOOOOIIIO	XXXXXXXXXDXXXXXXXXXXXXXXXXXXXXXXXXXXXXXXXX	1	{ (I301, 0) }
IOIOOOOIOOOOIOOIOIIOIIIOOOOOOOOOIIOIOIOIIOIIOOOOOOIIIO	XXXXXXXXXBXXXXXXXXXXXXXXXXXXXXXXXXXXXXXXXX	1	{ (I301, 1) }
IOOOOOOOOOOOIOOIOIIOIIOIOOOOOOOOIIOIIOOIIOIIOOOOOOIIIO	XXXXXXXXXXXDXXXXXXXXXXXXXXXXXXXXXXXXXXXXXX	1	{ (I315, 0) }
IIIIIIOOOOIOIOIIIIOOOIOIOIIOIIOOOIIIOOOIOIIIIOOOIIOOIO	XXXXXXXXXXXBXXXXXXXXXXXXXXXXXXXXXXXXXXXXXX	1	{ (I315, 1) }
IIIIIIIOOOOIOIOIIIIOOOIIOOIIOIIOOOIIIOOIOIIIIOOOIIOOIO	XXXXXXXXXXBXXXXXXXXXXXXXXXXXXXXXXXXXXXXXXX	1	{ (I306, 0) }
IIOIIIIOOOOIOIOIIIIOOOIIOOIIOIIOOOIIIOOIOIIIIOOOIIOOIO	XXXXXXXXXXDXXXXXXXXXXXXXXXXXXXXXXXXXXXXXXX	1	{ (I306, 1) }
IIOIIIIOOOOIOIOIIIIOOOIIOOIIOIIOOOIIIOOIOIIIIOOOIIOOIO	XXXXXXXXXXDXXXXXXXXXXXXXXXXXXXXXXXXXXXXXXX	1	{ (G282, 0) }
IIIIIIIOOOOIOIOIIIIOOOIIOOIIOIIOOOIIIOOIOIIIIOOOIIOOIO	XXXXXXXXXXBXXXXXXXXXXXXXXXXXXXXXXXXXXXXXXX	1	{ (G282, 1) }
IIOIIIIOOOOIOIOIIIIOOOIIOOIIOIIOOOIIIOOIOIIIIOOOIIOOIO	XXXXXXXXXXDXXXXXXXXXXXXXXXXXXXXXXXXXXXXXXX	1	{ (I308, 0) }
IIIIIIIOOOOIOIOIIIIOOOIIOOIIOIIOOOIIIOOIOIIIIOOOIIOOIO	XXXXXXXXXXBXXXXXXXXXXXXXXXXXXXXXXXXXXXXXXX	1	{ (I308, 1) }
IIOIIIOIOOIOIOIIIIOOOIIOOIIOIIOOOIIIOOOIOIIIIOOOIIOOIO	XXXXXXXXXDXXXXXXXXXXXXXXXXXXXXXXXXXXXXXXXX	1	{ (G232, 0) }
IIIIIIOIOOIOIOIIIIOOOIIOOIIOIIOOOIIIOOOIOIIIIOOOIIOOIO	XXXXXXXXXBXXXXXXXXXXXXXXXXXXXXXXXXXXXXXXXX	1	{ (G232, 1) }
IIOIIIIOOOOIOIOIIIIOOOIIOOIIOIIOOOIIIOOIOIIIIOOOIIOOIO	XXXXXXXXXXDXXXXXXXXXXXXXXXXXXXXXXXXXXXXXXX	1	{ (G233, 0) }
IIIIIIIOOOOIOIOIIIIOOOIIOOIIOIIOOOIIIOOIOIIIIOOOIIOOIO	XXXXXXXXXXBXXXXXXXXXXXXXXXXXXXXXXXXXXXXXXX	1	{ (G233, 1) }
IIOIIIOOOOIOIOIIIIOOOIOIOIIOIIOOOIIIOOOIOIIIIOOOIIOOIO	XXXXXXXXXXXDXXXXXXXXXXXXXXXXXXXXXXXXXXXXXX	1	{ (G234, 0) }
IIIIIIOOOOIOIOIIIIOOOIOIOIIOIIOOOIIIOOOIOIIIIOOOIIOOIO	XXXXXXXXXXXBXXXXXXXXXXXXXXXXXXXXXXXXXXXXXX	1	{ (G234, 1) }
IIOIIIOOIIOOIOIOIIIIOIOOIOOIIOIIOOOIOIIOOIOIIIIOOOIIOO	XXXXXXXXXDXXXXXXXXXXXXXXXXXXXXXXXXXXXXXXXX	1	{ (G248, 0) }
IOIOIOIOIIOOOOOOIOOIOIIIOOOIIIIOIIOOOIIIIIIIIIIIOOOOIO	XXXXXXXXXBXXXXXXXXXXXXXXXXXXXXXXXXXXXXXXXX	1	{ (G248, 1) }
IIOOOIOIOIIOOOOOOIOOIOIIIOOOIIIIOIIOOIIIIIIIIIIIOOOOIO	XXXXXXXXXXDXXXXXXXXXXXXXXXXXXXXXXXXXXXXXXX	1	{ (G263, 0) }
IIIOOIOIOIIOOOOOOIOOIOIIIOOOIIIIOIIOOIIIIIIIIIIIOOOOIO	XXXXXXXXXXBXXXXXXXXXXXXXXXXXXXXXXXXXXXXXXX	1	{ (G263, 1) }
IOOOIOIIIIOOOOOOIOOIOIIIOOOIIIIOIIOOIIOIIIIIIIIIOOOOIO	XXXXXXXXXXXDXXXXXXXXXXXXXXXXXXXXXXXXXXXXXX	1	{ (G264, 0) }
IOIOIOIIIIOOOOOOIOOIOIIIOOOIIIIOIIOOIIOIIIIIIIIIOOOOIO	XXXXXXXXXXXBXXXXXXXXXXXXXXXXXXXXXXXXXXXXXX	1	{ (G264, 1) }
IOOIIOIOOOOOOOIOOIOIIOOOIIIIIOIIOOIIIIIIIIIIIOOOOIOIOO	XXXXXXXXXXXXBXXXXXXXXXXXXXXXXXXXXXXXXXXXXX	1	{ (I546, 0) }
IOOIIOIOOOIOOOIOOIOIIOOOIIIIIOIIOOIIIIIIIIIIIOOOOIOIOO	XXXXXXXXXXXXDXXXXXXXXXXXXXXXXXXXXXXXXXXXXX	1	{ (I546, 1) }

Test vectors successfully generated [ 24.3917 seconds ].

Program successfully executed!
