Input gates:
G1  G2  G3  G4  G5  G6  G8  G9  G10  G11  G12  G13  G14  G15  G16  G17  G18  G19  G20  G21  G22  G23  G24  G25  G26  G27  G28  G29  G30  G31  G32  G33  G34  G35  G36  G64  G65  G66  G67  G68  G69  G70  G71  G72  G73  G74  G75  G76  G77  G78  G79  G80  G81  G82  
Output gates:
G103BF  G104BF  G105BF  G106BF  G107  G83  G84  G85  G86BF  G87BF  G88BF  G89BF  G90  G91  G92  G94  G95BF  G96BF  G97BF  G98BF  G99BF  G100BF  G101BF  G380  G262  G394  G250  G122  G133  G138  G139  G140  G141  G142  G125  G126  G127  G128  G129  G130  G131  G132  

Total Lines: 447

Test Vectors:
Format: <Pattern/Input> <Results/Output> <# Faults> {<List of Faults>}

IIIIIIIIOOOOOOOIOIIOOIOOIOIOOIIIIOIIOIIOOOOOIIOOOIOOOI	XXXXXXXXXBXXBXXXXXXXXXXXXXXXXXXXBDXXXXXXXX	1	{ (G3, 0) }
IIOIIIIIOOOOOOOIOIIOOIOOIOIOOIIIIOIIOIIOOOOOIIOOOIOOOI	XXXXXXXXXDXXDXXXXXXXXXXXXXXXXXXXDBXXXXXXXX	1	{ (G3, 1) }
OIIIOOOOIIIOIOOOIOOOOOOIIIOOIIIOOIIOIIIIIOIOIIIIIOIIIO	XXXXXXXXXXXXBXXXXXXXXDXXXXXXBBXXXXXXXXXXXX	1	{ (G4, 0) }
OIIOOOOOIIIOIOOOIOOOOOOIIIOOIIIOOIIOIIIIIOIOIIIIIOIIIO	XXXXXXXXXXXXDXXXXXXXXBXXXXXXDDXXXXXXXXXXXX	1	{ (G4, 1) }
IIOIOIOIOIOOOIIIOOOIOIOOOOOIIIOOIIIOOOIIOIOIIIOIOIIIII	XXXXXXXXXBXXBXXXXXXXXXXXXXXXXXXXBDXXXXXXXX	1	{ (G9, 0) }
IIOIOIOOOIOOOIIIOOOIOIOOOOOIIIOOIIIOOOIIOIOIIIOIOIIIII	XXXXXXXXXDXXDXXXXXXXXXXXXXXXXXXXDBXXXXXXXX	1	{ (G9, 1) }
IIOIOIOOIIOOOIIIOOOIOOIOOOOIIIOOIIIOIOIIOIOIIIOIOIIIII	XXXXXXXXXXBXBXXXXXXXXXXXXXXXXXXXBDXXXXXXXX	1	{ (G10, 0) }
IIOIOIOOOIOOOIIIOOOIOOIOOOOIIIOOIIIOIOIIOIOIIIOIOIIIII	XXXXXXXXXXDXDXXXXXXXXXXXXXXXXXXXDBXXXXXXXX	1	{ (G10, 1) }
IIOIOIOIOIOOOIIIOOOIOIOOOOOIIIOOIIIOOOIOIIOIIOIOIIIIIO	XXXXXXXXXBXXBXXXXXXXXXXXXXXXXXXXBDXXXXXXXX	1	{ (G11, 0) }
IIOIIIOIOOIOOOOIOOOIIIIOIOIOOIIIIIOOOOOOOIOOOOOIIIIIOO	XXXXXXXXXDXXDXXXXXXXXXXXXXXXXXXXDBXXXXXXXX	1	{ (G11, 1) }
IIOIIOOOOIIOOOIIIOIOIOOIIIIIIOOOOOOIOOOOIIIIIOOOIOIOOI	XXXXXXXXXXXXDXXXXXXXXXXXXXXXXXXXXXXXXXXXXX	1	{ (G12, 0) }
IIOIIOOOOIOOOOIIIOIOIOOIIIIIIOOOOOOIOOOOIIIIIOOOIOIOOI	XXXXXXXXXXXXBXXXXXXXXXXXXXXXXXXXXXXXXXXXXX	1	{ (G12, 1) }
IIOIIIOOOIIIOOOIOOOIIIIOIOIOOIIIIIOOOOOOOIOOOOOIIIIIOO	XXXXXXXXXBXXBXXXXXXXXXXXXXXXXXXXBDXXXXXXXX	1	{ (G13, 0) }
IIOIIIOOOIIOOOOIOOOIIIIOIOIOOIIIIIOOOOOOOIOOOOOIIIIIOO	XXXXXXXXXDXXDXXXXXXXXXXXXXXXXXXXDBXXXXXXXX	1	{ (G13, 1) }
IIOIOOOIOOOIIIOIOIOOIIIIIIOOOOOOIOOOOIIIIIOOOIOIOOIOIO	XXXXXXXXXXXXXDXXXXXXXXXXXXXXXXXXXXXXXXXXXX	1	{ (G27, 0) }
IIOIOOOIOOOIIIOIOIOOIIIIIOOOOOOOIOOOOIIIIIOOOIOIOOIOIO	XXXXXXXXXXXXXBXXXXXXXXXXXXXXXXXXXXXXXXXXXX	1	{ (G27, 1) }
IIOIIOOOIOIOIIOOIIIIIIOIIIOIOOOIOIOIIOIIIIOIOIIOOOIOII	XXXXXXXXXXXXXXXDXXXXXXXXXXXXXXXXXXXXXXXXXX	1	{ (G29, 0) }
IIOIIOOOIOIOIIOOIIIIIIOIIIOOOOOIOIOIIOIIIIOIOIIOOOIOII	XXXXXXXXXXXXXXXBXXXXXXXXXXXXXXXXXXXXXXXXXX	1	{ (G29, 1) }
IIOOIIOOOIOIOIIOIOIIIIIIOIIIOOOOIOIOIIOIIIIOIOIIOOIOIO	XXXXDXXXXXXXXXXXXXXXXXXXXXXXXXXXXXXXXXXXXX	1	{ (G107, 0) }
IIOIIIOOOIOIOIIOIOIIIIIIOIIIOOOOIOIOIIOIIIIOIOIIOOIOIO	XXXXBXXXXXXXXXXXXXXXXXXXXXXXXXXXXXXXXXXXXX	1	{ (G107, 1) }
IIOOIIOOOIOIOIIOOIIIIIIIOIIIOOOOIOIOIIOIIIIOIOIIOOOIIO	XXXXXDXXXXXXXXXXXXXXXXXXXXXXXXXXXXXXXXXXXX	1	{ (G83, 0) }
IIOIIIOOOIOIOIIOOIIIIIIIOIIIOOOOIOIOIIOIIIIOIOIIOOOIIO	XXXXXBXXXXXXXXXXXXXXXXXXXXXXXXXXXXXXXXXXXX	1	{ (G83, 1) }
IIOOIIOOOIOIOIIOOIIIIIIIOIIIOOOOIOIOIIOIIIIOIOIIOOOIIO	XXXXXXDXXXXXXXXXXXXXXXXXXXXXXXXXXXXXXXXXXX	1	{ (G84, 0) }
IIOIIIOOOIOIOIIOOIIIIIIIOIIIOOOOIOIOIIOIIIIOIOIIOOOIIO	XXXXXXBXXXXXXXXXXXXXXXXXXXXXXXXXXXXXXXXXXX	1	{ (G84, 1) }
OOIOOIIIOIOOOOOIIIOIIIIOOIIOOOIOOIOIIIOIOIIOIOOIIIIOOI	XXXXXXXDXXXXXXXXXXXXXXXXXXXXXXXXXXXXXXXXXX	1	{ (G85, 0) }
OOIIOIIIOIOOOOOIIIOIIIIOOIIOOOIOOIOIIIOIOIIOIOOIIIIOOI	XXXXXXXBXXXXXXXXXXXXXXXXXXXXXXXXXXXXXXXXXX	1	{ (G85, 1) }
OOIOIIIOIOOOOOIIIOIIIOOIIIOOOIOOIOIIIOIOIIOIOOIIIIOOOO	XXXXXXXXXXXXXDXXXXXXXXXXXXXXXXXXXXXXXXXXXX	1	{ (G91, 0) }
OOIOIIIOIOOOOOIIIOIIIOOIIOOOOIOOIOIIIOIOIIOIOOIIIIOOOO	XXXXXXXXXXXXXBXXXXXXXXXXXXXXXXXXXXXXXXXXXX	1	{ (G91, 1) }
OOIOIIIOIIIIOOOOOIIIOIIIOOIIIOOOIOOIOIIIOIOIIOIOOIIIIO	XXXXXXXXXXXXXXDXXXXXXXXXXXXXXXXXXXXXXXXXXX	1	{ (G92, 0) }
OOIOIIIOIOIIOOOOOIIIOIIIOOIIIOOOIOOIOIIIOIOIIOIOOIIIIO	XXXXXXXXXXXXXXBXXXXXXXXXXXXXXXXXXXXXXXXXXX	1	{ (G92, 1) }
OOIOIIIOIOOOOOIIIOIIIOOIIOOIOIOOIOIIIOIOIIOIOOIIIIOOOO	XXXXXXXXXXXXXXXDXXXXXXXXXXXXXXXXXXXXXXXXXX	1	{ (G94, 0) }
OOIOIIIOIOOOOOIIIOIIIOOIIOOOOIOOIOIIIOIOIIOIOOIIIIOOOO	XXXXXXXXXXXXXXXBXXXXXXXXXXXXXXXXXXXXXXXXXX	1	{ (G94, 1) }
IIIIOIOOIOOOOIIIOOIIOIIIIOIOOIOOIIIOIOIIOIIOIIOIIIIOOI	XXXXXXXXXXXXXXXXXDXXXXXXXXXXXXXXXXXXXXXXXX	1	{ (G96BF, 0) }
IIIOOIOOIOOOOIIIOOIIOIIIIOIOOIOOIIIOIOIIOIIOIIOIIIIOOI	XXXXXXXXXXXXXXXXXBXXXXXXXXXXXXXXXXXXXXXXXX	1	{ (G96BF, 1) }
IIIIOIOOIOOOOIIIOOIIOIIIIOIOOOOIIIIOIOIIOIIIOIOIIIIOOI	XXXXXXXXXXXXXXXXXXXDXXXXXXXXXXXXXXXXXXXXXX	1	{ (G98BF, 0) }
IIIOOIOOIOOOOIIIOOIIOIIIIOIOOOOIIIIOIOIIOIIIOIOIIIIOOI	XXXXXXXXXXXXXXXXXXXBXXXXXXXXXXXXXXXXXXXXXX	1	{ (G98BF, 1) }
IIIIOIOOIOOOOIIIOOIIOIIIIOIOOOOIIIIOIOIIIOIIOIOIIIIOOI	XXXXXXXXXXXXXXXXXXXXXDXXXXXXXXXXXXXXXXXXXX	1	{ (G100BF, 0) }
IIIOOIOOIOOOOIIIOOIIOIIIIOIOOOOIIIIOIOIIIOIIOIOIIIIOOI	XXXXXXXXXXXXXXXXXXXXXBXXXXXXXXXXXXXXXXXXXX	1	{ (G100BF, 1) }
IIIIOIOOIOOOOIIIOOIIOIIIIIOIOOOOIIIOIIOIIOIIOIOIIIIOOI	XXXXXXXXXDXXXXXXXXXXXXXXXXXXXXXXXXXXXXXXXX	1	{ (G65, 0) }
IIIIOIOOIOOOOIIIOOIIOIIIIIOIOOOOIIIOOIOIIOIIOIOIIIIOOI	XXXXXXXXXBXXXXXXXXXXXXXXXXXXXXXXXXXXXXXXXX	1	{ (G65, 1) }
OOIIOOOOOOIOOIIIOIOOOOIIOIIIIOOOOOOIOOIIIOOOOOIOIIIIII	XXXXXXXXXXXDXXXXXXXXXXXXXXXXXXXXXXXXXXXXXX	1	{ (G67, 0) }
OOIIOOOOOOIOOIIIOIOOOOIIOIIIIOOOOOOIOOOIIOOOOOIOIIIIII	XXXXXXXXXXXBXXXXXXXXXXXXXXXXXXXXXXXXXXXXXX	1	{ (G67, 1) }
OIOIIOOOOOIOOOIOOIIIOIOOOOIOIIIIOIOOOOOIIOOIIOOOOOIOII	XXXXXXXXXXXXDXXXXXXXXBXXXXXXDDXXXXXXXXXXXX	1	{ (G69, 0) }
OIOIIOOOOOIOOOIOOIIIOIOOOOIOIIIIOIOOOOOIOOOIIOOOOOIOII	XXXXXXXXXXXXBXXXXXXXXDXXXXXXBBXXXXXXXXXXXX	1	{ (G69, 1) }
OIOOIOOOOOOOOIOOIIIOIOOOOIOIIIIIOOOOIOOIOOIIIOOOOOIOII	XXXXXXXXXXXXDXXXXXXBXXXXXXXXXXDDXXXXXXXXXX	1	{ (G71, 0) }
OIOOIOOOOOOOOIOOIIIOIOOOOIOIIIIIOOOOIOOIOOOIIOOOOOIOII	XXXXXXXXXXXXBXXXXXXDXXXXXXXXXXBBXXXXXXXXXX	1	{ (G71, 1) }
OIOIIOOOOOIOOOIOOIIIOIOOOOIOIIIIIOOOOOOIOOOIIIOOOOOIOI	XXXXXXXXXXXXDXXXXBXXXXXXXXXXXXXXDDXXXXXXXX	1	{ (G73, 0) }
OIOIIOOOOOIOOOIOOIIIOIOOOOIOIIIIIOOOOOOIOOOIOIOOOOOIOI	XXXXXXXXXXXXBXXXXDXXXXXXXXXXXXXXBBXXXXXXXX	1	{ (G73, 1) }
OIIIIIIIIOOOIIOOIIIOOOOIOOIIOOIIIOOOOOIIOIIIOOIIIIIIII	XXXXXXXXXXXXXXXXXXXXXXXDXXXXXXXXXXXXXXXXXX	1	{ (G75, 0) }
OIIIIIIIIOOOIIOOIIIOOOOIOOIIOOIIIOOOOOIIOIIIOOOIIIIIII	XXXXXXXXXXXXXXXXXXXXXXXBXXXXXXXXXXXXXXXXXX	1	{ (G75, 1) }
OIIIIIIIIOOOIIOOIIIOOOOIOOIIOOIIIOOOOOIIOIIIOOIIIIIIII	XXXXXXXXXXXXXXXXXXXXXXXXXDXXXXXXXXXXXXXXXX	1	{ (G77, 0) }
OIIIIIIIIOOOIIOOIIIOOOOIOOIIOOIIIOOOOOIIOIIIOOIIOIIIII	XXXXXXXXXXXXXXXXXXXXXXXXXBXXXXXXXXXXXXXXXX	1	{ (G77, 1) }
OOIIIIIIIIOOOIIOOIIIOOIOOIOOIIOOIIIOOIOOOIIOIIIOOIIIII	XXXXXXXXXXBXXXXXXXXXXXXXXXXXXXXXXXXXXXXXXX	1	{ (G78, 0) }
OOIIIIIIIIOOOIIOOIIIOOIOOIOOIIOOIIIOOIOOOIIOIIIOOOIIII	XXXXXXXXXXDXXXXXXXXXXXXXXXXXXXXXXXXXXXXXXX	1	{ (G78, 1) }
OIIOIIIIIOOOIIOOIIIIOOOOIOOIIOOIIIOOOOOIIOIIIOOIIIIIII	XXXXDXXXXXXXXXXXXXXXXXXXXXXXXXXXXXXXXXXXXX	1	{ (G79, 0) }
OIIOIIIIIOOOIIOOIIIIOOOOIOOIIOOIIIOOOOOIIOIIIOOIIIOIII	XXXXBXXXXXXXXXXXXXXXXXXXXXXXXXXXXXXXXXXXXX	1	{ (G79, 1) }
OIIOIIIIIOOOIIOOIIIIOOOOIOOIIOOIIIOOOOOIIOIIIOOIIIIIII	XXXXXDXXXXXXXXXXXXXXXXXXXXXXXXXXXXXXXXXXXX	1	{ (G80, 0) }
IOOOIIIOOIOIIIIIIIIIOIOIIIIIOIOOIIOOOIIIIIIOOOIIIIIOIO	XXXXXBXXXXXXXXXXXXXXXXXXXXXXXXXXXXXXXXXXXX	1	{ (G80, 1) }
IOOOIIIOOIOIIIIIIIIIOIOIIIIIOIOOIIOOOIIIIIIOOOIIIIIIIO	XXXXXXDXXXXXXXXXXXXXXXXXXXXXXXXXXXXXXXXXXX	1	{ (G81, 0) }
IOOOIIIOOIOIIIIIIIIIOIOIIIIIOIOOIIOOOIIIIIIOOOIIIIIIOO	XXXXXXBXXXXXXXXXXXXXXXXXXXXXXXXXXXXXXXXXXX	1	{ (G81, 1) }
IOOOIIIOOIOIIIIIIIIIOIOIIIIIOIOOIIOOOIIIIIIOOOIIIIIIOI	XXXXXXXDXXXXXXXXXXXXXXXXXXXXXXXXXXXXXXXXXX	1	{ (G82, 0) }
IOOOIIIOOIOIIIIIIIIIOIOIIIIIOIOOIIOOOIIIIIIOOOIIIIIIOO	XXXXXXXBXXXXXXXXXXXXXXXXXXXXXXXXXXXXXXXXXX	1	{ (G82, 1) }
IIOIIIOIOOOOIIIOOIOIIIIIIIIIOIOIIIIIOOIOOIOIOOOIOIIIII	XXXXXXXXXDXXDXXXXXXXXXXXXXXXXXXXDBXXXXXXXX	1	{ (G379, 0) }
IIIIIIOIOOOOIIIOOIOIIIIIIIIIOIOIIIIIOOIOOIOIOOOIOIIIII	XXXXXXXXXBXXBXXXXXXXXXXXXXXXXXXXBDXXXXXXXX	1	{ (G379, 1) }
IIOOOIIOIOIOOIOIIIIIIIIOIOIIIIIOIIOOIIOOIOIIIIIIOOOIII	XXXXXXXXXXXXDXXXXXXXXBXXXXXXDDXXXXXXXXXXXX	1	{ (I643, 0) }
IIOIOIIOIOIOOIOIIIIIIIIOIOIIIIIOIIOOIIOOIOIIIIIIOOOIII	XXXXXXXXXXXXBXXXXXXXXDXXXXXXBBXXXXXXXXXXXX	1	{ (I643, 1) }
IIOIIIIOOIOOIOOIIOIIIIIOIIIOIIOIOIOOOOIIIOOOOIIIIIIIIO	XXXXXXXXXDXXDXXXXXXXXXXXXXXXXXXXDBXXXXXXXX	1	{ (I655, 0) }
IIOIIIIIOIOOIOOIIOIIIIIOIIIOIIOIOIOOOOIIIOOOOIIIIIIIIO	XXXXXXXXXBXXBXXXXXXXXXXXXXXXXXXXBDXXXXXXXX	1	{ (I655, 1) }
IIOIIIIOOIOOIOOIIOIIIIIOIIIOIIOIOIOOIOIIIOOOOIIIIIIIIO	XXXXXXXXXXDXDXXXXXXXXXXXXXXXXXXXDBXXXXXXXX	1	{ (I660, 0) }
IIOIIIIOIIOOIOOIIOIIIIIOIIIOIIOIOIOOIOIIIOOOOIIIIIIIIO	XXXXXXXXXXBXBXXXXXXXXXXXXXXXXXXXBDXXXXXXXX	1	{ (I660, 1) }
IIOIIIIIOOOOIOOIIOIIIIIOIIIOIIOIOIOOOOIIOOOOIIIIIIIIOO	XXXXXXXXXDXXDXXXXXXXXXXXXXXXXXXXDBXXXXXXXX	1	{ (I680, 0) }
IIOIIIIIOIOOIOOIIOIIIIIOIIIOIIOIOIOOOOIIOOOOIIIIIIIIOO	XXXXXXXXXBXXBXXXXXXXXXXXXXXXXXXXBDXXXXXXXX	1	{ (I680, 1) }
IIIIOIOOOIOIOIIIIOIIIOIIIOIOIOOOIIOOOIIIIIIIIOOOIIOOOO	XXXXXXXXXXXXBXXXXXXXXXXXXXXXXXXXXXXXXXXXXX	1	{ (I684, 0) }
IIIIOIOOOIIIOIIIIOIIIOIIIOIOIOOOIIOOOIIIIIIIIOOOIIOOOO	XXXXXXXXXXXXDXXXXXXXXXXXXXXXXXXXXXXXXXXXXX	1	{ (I684, 1) }
IIOIIIIOOIOOIOOIIOIIIIIOIIIOIIOIOIOOOOIIOOOOIIIIIIIIOO	XXXXXXXXXDXXDXXXXXXXXXXXXXXXXXXXDBXXXXXXXX	1	{ (I687, 0) }
IIOIIOIOOIIIIOIOIOIOIIOIIIOIOIIOOIIOOIIIOOOOIOIIIIIIOI	XXXXXXXXXBXXBXXXXXXXXXXXXXXXXXXXBDXXXXXXXX	1	{ (I687, 1) }
IOIIIOIOIOIOIOIIIOIOIIOOIOIOIIIOOOIOIIIIIIOIOIIIOIOOOI	XXXXXXXXXXXXXBXXXXXXXXXXXXXXXXXXXXXXXXXXXX	1	{ (I165, 0) }
IOIIIOIOIOIOIOIIIOIOIIOOIIIOIIIOOOIOIIIIIIOIOIIIOIOOOI	XXXXXXXXXXXXXDXXXXXXXXXXXXXXXXXXXXXXXXXXXX	1	{ (I165, 1) }
IOIIIOIOIOIOIOIIIOIOIIOOIIOOIIIOOOIOIIIIIIOIOIIIOIOOOI	XXXXXXXXXXXXXXXBXXXXXXXXXXXXXXXXXXXXXXXXXX	1	{ (II178, 0) }
IOIIIOIOIOIOIOIIIOIOIIOOIIOIIIIOOOIOIIIIIIOIOIIIOIOOOI	XXXXXXXXXXXXXXXDXXXXXXXXXXXXXXXXXXXXXXXXXX	1	{ (II178, 1) }
IIOOIIIOOIOOIOIOIOIIIOIOIIOOIIOIIIIOIOOIOIOIIIIIOIOIII	XXXXXXXXXXXXBXXXXXXDXXXXXXXXXXBBXXXXXXXXXX	1	{ (I172, 0) }
IIOOIIIOOIOOIOIOIOIIIOIOIIOOIIOIIIIOIOOIOIIIIIIIOIOIII	XXXXXXXXXXXXDXXXXXXBXXXXXXXXXXDDXXXXXXXXXX	1	{ (I172, 1) }
IIOOIIIOOIOOIOIOIOIIIOIOIIOOIIOIIIIOIOOIOIIIIIIIOIOIII	XXXXXXXXXXXXDXXXXXXBXXXXXXXXXXDDXXXXXXXXXX	1	{ (G115, 0) }
IIOOIIIOOIOOIOIOIOIIIOIOIIOOIIOIIIIOIOOIOIOIIIIIOIOIII	XXXXXXXXXXXXBXXXXXXDXXXXXXXXXXBBXXXXXXXXXX	1	{ (G115, 1) }
IIIOIOIIOIIOIOIOIIIIOOIIIIIIOOIIIIOOOIIOIIIIOIOOOOIOOO	XXXXXBXXXXXXXXXXXXXXXXXXXXXXXXXXXXXXXXXXXX	1	{ (I178, 0) }
IIIOIOIIOIIOIOIOIIIIOOIIIIIIOOIIIIOOOIIOIIIIOIOOOOIIOO	XXXXXDXXXXXXXXXXXXXXXXXXXXXXXXXXXXXXXXXXXX	1	{ (I178, 1) }
IIIOIOIIOIIOIOIOIIIIOOIIIIIIOOIIIIOOOIIOIIIIOIOOOOIIOO	XXXXXDXXXXXXXXXXXXXXXXXXXXXXXXXXXXXXXXXXXX	1	{ (G219, 0) }
IIIOIOIIOIIOIOIOIIIIOOIIIIIIOOIIIIOOOIIOIIIIOIOOOOIOOO	XXXXXBXXXXXXXXXXXXXXXXXXXXXXXXXXXXXXXXXXXX	1	{ (G219, 1) }
IIIIIIOOIIIOOIIOIOIOIIIOOIIIIIIIOOIIIIOOOIOIOOIIIIOIOO	XXXXXXXXXXXXBXXXXDXXXXXXXXXXXXXXBBXXXXXXXX	1	{ (I181, 0) }
IIIIIIOOIIIOOIIOIOIOIIIOOIIIIIIIOOIIIIOOOIOIIOIIIIOIOO	XXXXXXXXXXXXDXXXXBXXXXXXXXXXXXXXDDXXXXXXXX	1	{ (I181, 1) }
IIIIIIOOIIIOOIIOIOIOIIIOOIIIIIIIOOIIIIOOOIOIIOIIIIOIOO	XXXXXXXXXXXXDXXXXBXXXXXXXXXXXXXXDDXXXXXXXX	1	{ (G119, 0) }
IIIIIIOOIIIOOIIOIOIOIIIOOIIIIIIIOOIIIIOOOIOIOOIIIIOIOO	XXXXXXXXXXXXBXXXXDXXXXXXXXXXXXXXBBXXXXXXXX	1	{ (G119, 1) }
IIIOIOIIOIIOIOIOIIIIOOIIIIIIOOIIIIOOOIIOIIIIOIOOOOIOOO	XXXXXXBXXXXXXXXXXXXXXXXXXXXXXXXXXXXXXXXXXX	1	{ (I184, 0) }
OIIOIIOOOIOIIOOOIOIOIOIIOOIOIIOOOOIIOOIOOOOIOIIOOOIIIO	XXXXXXDXXXXXXXXXXXXXXXXXXXXXXXXXXXXXXXXXXX	1	{ (I184, 1) }
OIIOIIOOOIOIIOOOIOIOIOIIOOIOIIOOOOIIOOIOOOOIOIIOOOIIIO	XXXXXXDXXXXXXXXXXXXXXXXXXXXXXXXXXXXXXXXXXX	1	{ (G221, 0) }
OIIOIIOOOIOIIOOOIOIOIOIIOOIOIIOOOOIIOOIOOOOIOIIOOOIIOO	XXXXXXBXXXXXXXXXXXXXXXXXXXXXXXXXXXXXXXXXXX	1	{ (G221, 1) }
OIIOIIOOOIOIIOOOIOOIIOIIOOIOIIOOOOIIOOIOOOOIOIIOOOIIOO	XXXXXXXBXXXXXXXXXXXXXXXXXXXXXXXXXXXXXXXXXX	1	{ (I190, 0) }
OIIOIIOOOIOIIOOOIOOIIOIIOOIOIIOOOOIIOOIOOOOIOIIOOOIIOI	XXXXXXXDXXXXXXXXXXXXXXXXXXXXXXXXXXXXXXXXXX	1	{ (I190, 1) }
OIIOIIOOOIOIIOOOIOOIIOIIOOIOIIOOOOIIOOIOOOOIOIIOOOIIOI	XXXXXXXDXXXXXXXXXXXXXXXXXXXXXXXXXXXXXXXXXX	1	{ (G223, 0) }
OIIOIIOOOIOIIOOOIOOIIOIIOOIOIIOOOOIIOOIOOOOIOIIOOOIIOO	XXXXXXXBXXXXXXXXXXXXXXXXXXXXXXXXXXXXXXXXXX	1	{ (G223, 1) }
OIIIIIOOOIOIIOOOIOOIOIIOOIOIIOOOOIIOOIOOOOIOIIOOOOIIOO	XXXXXXXXXXXXXXXXXXXXXXXBXXXXXXXXXXXXXXXXXX	1	{ (I193, 0) }
OIIIIIOOOIOIIOOOIOOIOIIOOIOIIOOOOIIOOIOOOOIOIIIOOOIIOO	XXXXXXXXXXXXXXXXXXXXXXXDXXXXXXXXXXXXXXXXXX	1	{ (I193, 1) }
OIIIIIOOOIOIIOOOIOOIOIIOOIOIIOOOOIIOOIOOOOIOIIIOOOIIOO	XXXXXXXXXXXXXXXXXXXXXXXDXXXXXXXXXXXXXXXXXX	1	{ (G209, 0) }
IOIOOOOOOIIOIOOIIOOOIIOOOIOOIIOOOOOOOOOOIIIIOIOOIIOIOI	XXXXXXXXXXXXXXXXXXXXXXXBXXXXXXXXXXXXXXXXXX	1	{ (G209, 1) }
IIOIOOOOOOIOOIIOIOOIIOOOIIOOOIOOIIIOOOOOOOOOOOIIIIOIOI	XXXXXXXXXXXXBXXXXXXXXDXXXXXXBBXXXXXXXXXXXX	1	{ (I202, 0) }
IIOIOOOOOOIOOIIOIOOIIOOOIIOOOIOOIIIOOOOOIOOOOOIIIIOIOI	XXXXXXXXXXXXDXXXXXXXXBXXXXXXDDXXXXXXXXXXXX	1	{ (I202, 1) }
IIOIOOOOOOIOOIIOIOOIIOOOIIOOOIOOIIIOOOOOIOOOOOIIIIOIOI	XXXXXXXXXXXXDXXXXXXXXBXXXXXXDDXXXXXXXXXXXX	1	{ (G111, 0) }
IIOIOOOOOOIOOIIOIOOIIOOOIIOOOIOOIIIOOOOOOOOOOOIIIIOIOI	XXXXXXXXXXXXBXXXXXXXXDXXXXXXBBXXXXXXXXXXXX	1	{ (G111, 1) }
IOIOOOOOOIIOIOOIIOOOIIOOOIOOIIOOOOOOOOOOIIIIOIOIOIOIOI	XXXXXXXXXXXXXXXXXXXXXXXXXBXXXXXXXXXXXXXXXX	1	{ (I205, 0) }
IOIOOOOOOIIOIOOIIOOOIIOOOIOOIIOOOOOOOOOOIIIIOIOIIIOIOI	XXXXXXXXXXXXXXXXXXXXXXXXXDXXXXXXXXXXXXXXXX	1	{ (I205, 1) }
IOIOOOOOOIIOIOOIIOOOIIOOOIOOIIOOOOOOOOOOIIIIOIOIIIOIOI	XXXXXXXXXXXXXXXXXXXXXXXXXDXXXXXXXXXXXXXXXX	1	{ (G213, 0) }
IOIOOOOOOIIOIOOIIOOOIIOOOIOOIIOOOOOOOOOOIIIIOIOIOIOIOI	XXXXXXXXXXXXXXXXXXXXXXXXXBXXXXXXXXXXXXXXXX	1	{ (G213, 1) }
OOIOOOIIOOIIOIIOOIIIOOIOIIIIOIOIIIIIIIOOIOOOIIIOIOIIIO	XXXXXXXXXXDXXXXXXXXXXXXXXXXXXXXXXXXXXXXXXX	1	{ (I208, 0) }
OOIOOOIIOOIIOIIOOIIIOOIOIIIIOIOIIIIIIIOOIOOOIIIOIIIIIO	XXXXXXXXXXBXXXXXXXXXXXXXXXXXXXXXXXXXXXXXXX	1	{ (I208, 1) }
OOIOOOIIOOIIOIIOOIIIOOIOIIIIOIOIIIIIIIOOIOOOIIIOIIIIIO	XXXXXXXXXXBXXXXXXXXXXXXXXXXXXXXXXXXXXXXXXX	1	{ (G215, 0) }
OOIOOOIIOOIIOIIOOIIIOOIOIIIIOIOIIIIIIIOOIOOOIIIOIOIIIO	XXXXXXXXXXDXXXXXXXXXXXXXXXXXXXXXXXXXXXXXXX	1	{ (G215, 1) }
OOOOOIIOOIIOIIOOIIIIOOOIIIIOIOIIIIIIOOIOOOIIIOIIIIOOOI	XXXXBXXXXXXXXXXXXXXXXXXXXXXXXXXXXXXXXXXXXX	1	{ (I211, 0) }
OOOOOIIOOIIOIIOOIIIIOOOIIIIOIOIIIIIIOOIOOOIIIOIIIIIOOI	XXXXDXXXXXXXXXXXXXXXXXXXXXXXXXXXXXXXXXXXXX	1	{ (I211, 1) }
OOOOOIIOOIIOIIOOIIIIOOOIIIIOIOIIIIIIOOIOOOIIIOIIIIIOOI	XXXXDXXXXXXXXXXXXXXXXXXXXXXXXXXXXXXXXXXXXX	1	{ (G217, 0) }
OOOOOIIOOIIOIIOOIIIIOOOIIIIOIOIIIIIIOOIOOOIIIOIIIIOOOI	XXXXBXXXXXXXXXXXXXXXXXXXXXXXXXXXXXXXXXXXXX	1	{ (G217, 1) }
OIOIOOIOIOIOOIIOIIOOIIIOOOIIIIOIOIIIIIIIIOOIOOOIIIOIII	XXXXXXXXXXXXBXXXXXXXXDXXXXXXBBXXXXXXXXXXXX	1	{ (G360, 0) }
OIOOOOIOIOIOOIIOIIOOIIIOOOIIIIOIOIIIIIIIIOOIOOOIIIOIII	XXXXXXXXXXXXDXXXXXXXXBXXXXXXDDXXXXXXXXXXXX	1	{ (G360, 1) }
IIOIIOIIOIOOIIOIOOIOIIIOIOOOOIIOIOIOOOIOIOOIOIOIOOOOOI	XXXXXXXXXBXXBXXXXXXXXXXXXXXXXXXXBDXXXXXXXX	1	{ (G364, 0) }
IIOIIOIOOIOOIIOIOOIOIIIOIOOOOIIOIOIOOOIOIOOIOIOIOOOOOI	XXXXXXXXXDXXDXXXXXXXXXXXXXXXXXXXDBXXXXXXXX	1	{ (G364, 1) }
IIOIIOIOIIOOIIOIOOIOIIIOIOOOOIIOIOIOIOIOIOOIOIOIOOOOOI	XXXXXXXXXXBXBXXXXXXXXXXXXXXXXXXXBDXXXXXXXX	1	{ (G367, 0) }
IIOIIOIOOIOOIIOIOOIOIIIOIOOOOIIOIOIOIOIOIOOIOIOIOOOOOI	XXXXXXXXXXDXDXXXXXXXXXXXXXXXXXXXDBXXXXXXXX	1	{ (G367, 1) }
IIOIIOIIOIOOIIOIOOIOIIIOIOOOOIIOIOIOOOOIOIOOIOIOOOOOII	XXXXXXXXXBXXBXXXXXXXXXXXXXXXXXXXBDXXXXXXXX	1	{ (G386, 0) }
IIOIIOIIOOOOIIOIOOIOIIIOIOOOOIIOIOIOOOOIOIOOIOIOOOOOII	XXXXXXXXXDXXDXXXXXXXXXXXXXXXXXXXDBXXXXXXXX	1	{ (G386, 1) }
IOIIOIIOOIIOOIOIIOIOOOOIIIOIOIOOOIOIOIOIOOOOOIIOIIIIIO	XXXXXXXXXXXXDXXXXXXXXXXXXXXXXXXXXXXXXXXXXX	1	{ (G388, 0) }
IOIIOIIOOIOOOIOIIOIOOOOIIIOIOIOOOIOIOIOIOOOOOIIOIIIIIO	XXXXXXXXXXXXBXXXXXXXXXXXXXXXXXXXXXXXXXXXXX	1	{ (G388, 1) }
IIOIIOIOOIOIIIOIOOIOIIIOIOOOOIIOIOIOOOOIOIOOIOIOOOOOII	XXXXXXXXXBXXBXXXXXXXXXXXXXXXXXXXBDXXXXXXXX	1	{ (G389, 0) }
IIOIIOIOOIOOIIOIOOIOIIIOIOOOOIIOIOIOOOOIOIOOIOIOOOOOII	XXXXXXXXXDXXDXXXXXXXXXXXXXXXXXXXDBXXXXXXXX	1	{ (G389, 1) }
IIIOOIIOIIIOIIIOIIOOIIOOIIOIIOIOIIOIIOOIIIIIIIOOIIIIIO	XXXXXXXXXXXXDXXXXXXXXBXXXXXXDDXXXXXXXXXXXX	1	{ (G110, 0) }
IIIIOIIOIIIOIIIOIIOOIIOOIIOIIOIOIIOIIOOIIIIIIIOOIIIIIO	XXXXXXXXXXXXBXXXXXXXXDXXXXXXBBXXXXXXXXXXXX	1	{ (G110, 1) }
IIIOOIIIOIIOIIOIIOOIIOOIIOIIOIOIIOIIIOOIIIIIIIOOIIIIIO	XXXXXXXXXXXXDXXXXXXBXXXXXXXXXXDDXXXXXXXXXX	1	{ (G114, 0) }
IIIIOIIIOIIOIIOIIOOIIOOIIOIIOIOIIOIIIOOIIIIIIIOOIIIIIO	XXXXXXXXXXXXBXXXXXXDXXXXXXXXXXBBXXXXXXXXXX	1	{ (G114, 1) }
IIIOOIIOIIIOIIIOIIOOIIOOIIOIIIOIOIOIIOOIIIOIIIIOOIIIII	XXXXXXXXXXXXDXXXXBXXXXXXXXXXXXXXDDXXXXXXXX	1	{ (G118, 0) }
IIIIOIIOIIIOIIIOIIOOIIOOIIOIIIOIOIOIIOOIIIOIIIIOOIIIII	XXXXXXXXXXXXBXXXXDXXXXXXXXXXXXXXBBXXXXXXXX	1	{ (G118, 1) }
IIOOIIIIIIIOIIOOIIIOOIIOIIOIOIOIIOOIIIIIIOOIIIIIOIIIOO	XXXXDXXXXXXXXXXXXXXXXXXXXXXXXXXXXXXXXXXXXX	1	{ (G216, 0) }
IIOIIIIIIIIOIIOOIIIOOIIOIIOIOIOIIOOIIIIIIOOIIIIIOIIIOO	XXXXBXXXXXXXXXXXXXXXXXXXXXXXXXXXXXXXXXXXXX	1	{ (G216, 1) }
IIOOIIIIIIIOIIOOIIIOOIIOIIOIOIOIIOOIIIIIIOOIIIIIOIIIOO	XXXXXDXXXXXXXXXXXXXXXXXXXXXXXXXXXXXXXXXXXX	1	{ (G218, 0) }
IIOIIIIIIIIOIIOOIIIOOIIOIIOIOIOIIOOIIIIIIOOIIIIIOIIIOO	XXXXXBXXXXXXXXXXXXXXXXXXXXXXXXXXXXXXXXXXXX	1	{ (G218, 1) }
OIIOOOIOIIIIOIOIOOIOIIOOOIIIIOOIIIIOIIIIOIOOIIOOIOIOIO	XXXXXXDXXXXXXXXXXXXXXXXXXXXXXXXXXXXXXXXXXX	1	{ (G220, 0) }
OIIIOOIOIIIIOIOIOOIOIIOOOIIIIOOIIIIOIIIIOIOOIIOOIOIOIO	XXXXXXBXXXXXXXXXXXXXXXXXXXXXXXXXXXXXXXXXXX	1	{ (G220, 1) }
OIIOOOIOIIIIOIOIOOOIIIOOOIIIIOOIIIIOIIIIOIOOIIOOIOIOOI	XXXXXXXDXXXXXXXXXXXXXXXXXXXXXXXXXXXXXXXXXX	1	{ (G222, 0) }
OIIIOOIOIIIIOIOIOOOIIIOOOIIIIOOIIIIOIIIIOIOOIIOOIOIOOI	XXXXXXXBXXXXXXXXXXXXXXXXXXXXXXXXXXXXXXXXXX	1	{ (G222, 1) }
IIOIOIIOOIOOOIOIIIIOIIOIOOOIIOOOIIIIOOIOIIOIIOIIIIOIOO	XXXXXXXXXDXXDXXXXXXXXXXXXXXXXXXXDBXXXXXXXX	1	{ (G365, 0) }
IIOIOIIIOIOOOIOIIIIOIIOIOOOIIOOOIIIIOOIOIIOIIOIIIIOIOO	XXXXXXXXXBXXBXXXXXXXXXXXXXXXXXXXBDXXXXXXXX	1	{ (G365, 1) }
IIOIOIIOOIOOOIOIIIIOIOIIOOOIIOOOIIIIIOIOIIOIIOIIIIOIOO	XXXXXXXXXXDXDXXXXXXXXXXXXXXXXXXXDBXXXXXXXX	1	{ (G368, 0) }
IIOIOIIOIIOOOIOIIIIOIOIIOOOIIOOOIIIIIOIOIIOIIOIIIIOIOO	XXXXXXXXXXBXBXXXXXXXXXXXXXXXXXXXBDXXXXXXXX	1	{ (G368, 1) }
IIOIOIIIOOOOOIOIIIIOIIOIOOOIIOOOIIIIOOOIIIOIOIIIIOIOOI	XXXXXXXXXDXXDXXXXXXXXXXXXXXXXXXXDBXXXXXXXX	1	{ (G387, 0) }
IIOIOIIIOIOOOIOIIIIOIIOIOOOIIOOOIIIIOOOIIIOIOIIIIOIOOI	XXXXXXXXXBXXBXXXXXXXXXXXXXXXXXXXBDXXXXXXXX	1	{ (G387, 1) }
OIIIOOIOOIOIIIOIOIOOOIIOIOOIIIIOOIIIIOIIIIOIOOIIOOIOIO	XXXXXXXXXXXXBXXXXXXXXXXXXXXXXXXXXXXXXXXXXX	1	{ (G225, 0) }
OIIIIIIOIOIIIOIIOIOOIOIOIOIIIIOOIIOOOIIOOOOIIOOOOIIOOI	XXXXXXXXXXXXDXXXXXXXXXXXXXXXXXXXXXXXXXXXXX	1	{ (G225, 1) }
IIOIOIIOOIIOIIIOIIOIIIOIOOIOIOOIIIIOOOIIOOOOIIOOOOIIOO	XXXXXXXXXDXXDXXXXXXXXXXXXXXXXXXXDBXXXXXXXX	1	{ (G390, 0) }
IIOIOIIOOIIIIIIOIIOIIIOIOOIOIOOIIIIOOOIIOOOOIIOOOOIIOO	XXXXXXXXXBXXBXXXXXXXXXXXXXXXXXXXBDXXXXXXXX	1	{ (G390, 1) }
OIIIIIIOIOIIIOIIOIOOIOIOOIIIIIOOIIOOOIIOOOOIIOOOOIIOOI	XXXXXXXXXXXXXXBXXXXXXXXXXXXXXXXXXXXXXXXXXX	1	{ (I356, 0) }
OIIIIIIOIIIIIOIIOIOOIOIOOIIIIIOOIIOOOIIOOOOIIOOOOIIOOI	XXXXXXXXXXXXXXDXXXXXXXXXXXXXXXXXXXXXXXXXXX	1	{ (I356, 1) }
OIIIIIIOIIIIIOIIOIOOIOIOOIIIIIOOIIOOOIIOOOOIIOOOOIIOOI	XXXXXXXXXXXXXXDXXXXXXXXXXXXXXXXXXXXXXXXXXX	1	{ (G289, 0) }
OIIIIIIOIOIIIOIIOIOOIOIOOIIIIIOOIIOOOIIOOOOIIOOOOIIOOI	XXXXXXXXXXXXXXBXXXXXXXXXXXXXXXXXXXXXXXXXXX	1	{ (G289, 1) }
OIIOIIIOIIIOOIIOIIOIOOIOIOOIIIIOOIIIOOOIIIOOOOIIOOOOII	XXXXXXXXXXXXDXXXXXXXXBXXXXXXDDXXXXXXXXXXXX	1	{ (G324, 0) }
OIIIIIIOIIIOOIIOIIOIOOIOIOOIIIIOOIIIOOOIIIOOOOIIOOOOII	XXXXXXXXXXXXBXXXXXXXXDXXXXXXBBXXXXXXXXXXXX	1	{ (G324, 1) }
OIIIIIIIOIIOIIOIOOIOIOOIIIIOOIIOOIOIIOOOIOIIOOOOIIOOII	XXXXXXXXXXXXXXXXXXXXXDXXXXXXXXXXXXXXXXXXXX	1	{ (I257, 0) }
OOIOOIOOIOIOOOIIIOOIOOOOOOIOOOOIOIOOOOIOIIIIOOIIIIIIOI	XXXXXXXXXXXXXXXXXXXXXBXXXXXXXXXXXXXXXXXXXX	1	{ (I257, 1) }
OOIOOIOOIOIOOOIIIOOIOOOOOOIOOOOIOIOOOOIOIIIIOOIIIIIIOI	XXXXXXXXXXXXXXXXXXXXXBXXXXXXXXXXXXXXXXXXXX	1	{ (G325, 0) }
OOIIOIOOIOIOOOIIIOOIOOOOOOIOOOOIOIOOOOIOIIIIOOIIIIIIOI	XXXXXXXXXXXXXXXXXXXXXDXXXXXXXXXXXXXXXXXXXX	1	{ (G325, 1) }
OIOOIOIOOOIOOIOOOIIIOOIOOOOOOIOIOOOIIOOOOOIIOIIIOOIIII	XXXXXXXXXXXXDXXXXXXBXXXXXXXXXXDDXXXXXXXXXX	1	{ (G338, 0) }
OIOIIOIOOOIOOIOOOIIIOOIOOOOOOIOIOOOIIOOOOOIIOIIIOOIIII	XXXXXXXXXXXXBXXXXXXDXXXXXXXXXXBBXXXXXXXXXX	1	{ (G338, 1) }
OOIIOIOOIOIOOOIIIOOIOOOOOOIOOOOIIOOOOOIOIIIIOOIIIIIIOI	XXXXXXXXXXXXXXXXXXXDXXXXXXXXXXXXXXXXXXXXXX	1	{ (I263, 0) }
OOIOOIOOIOIOOOIIIOOIOOOOOOIOOOOIIOOOOOIOIIIIOOIIIIIIOI	XXXXXXXXXXXXXXXXXXXBXXXXXXXXXXXXXXXXXXXXXX	1	{ (I263, 1) }
OOIOOIOOIOIOOOIIIOOIOOOOOOIOOOOIIOOOOOIOIIIIOOIIIIIIOI	XXXXXXXXXXXXXXXXXXXBXXXXXXXXXXXXXXXXXXXXXX	1	{ (G339, 0) }
OOIIOIOOIOIOOOIIIOOIOOOOOOIOOOOIIOOOOOIOIIIIOOIIIIIIOI	XXXXXXXXXXXXXXXXXXXDXXXXXXXXXXXXXXXXXXXXXX	1	{ (G339, 1) }
OIOOIOIOOOIOIOIOOOIIIOOIOOOOOIOIOOOOIOOOOOOIIOIIIOOIII	XXXXXXXXXXXXDXXXXBXXXXXXXXXXXXXXDDXXXXXXXX	1	{ (G344, 0) }
OIOIIOIOOOIOIOIOOOIIIOOIOOOOOIOIOOOOIOOOOOOIIOIIIOOIII	XXXXXXXXXXXXBXXXXDXXXXXXXXXXXXXXBBXXXXXXXX	1	{ (G344, 1) }
IIOIOIIOIIOOOIIOIIIIIIOOOIOOOIOIOIOOIOIIIIOIIIIOIOOOII	XXXXXXXXXXXXXXXXXDXXXXXXXXXXXXXXXXXXXXXXXX	1	{ (I269, 0) }
IIOOOIIOIIOOOIIOIIIIIIOOOIOOOIOIOIOOIOIIIIOIIIIOIOOOII	XXXXXXXXXXXXXXXXXBXXXXXXXXXXXXXXXXXXXXXXXX	1	{ (I269, 1) }
IIOOOIIOIIOOOIIOIIIIIIOOOIOOOIOIOIOOIOIIIIOIIIIOIOOOII	XXXXXXXXXXXXXXXXXBXXXXXXXXXXXXXXXXXXXXXXXX	1	{ (G345, 0) }
IIOIOIIOIIOOOIIOIIIIIIOOOIOOOIOIOIOOIOIIIIOIIIIOIOOOII	XXXXXXXXXXXXXXXXXDXXXXXXXXXXXXXXXXXXXXXXXX	1	{ (G345, 1) }
IIOIOIIOIIOOOIIOIIIIIIIOOOIOOOOIOIOOIOIIIIOIIIOIOOIOII	XXXXBXXXXXXXXXXXXXXXXXXXXXXXXXXXXXXXXXXXXX	1	{ (I272, 0) }
IIOOOIIOIIOOOIIOIIIIIIIOOOIOOOOIOIOOIOIIIIOIIIOIOOIOII	XXXXDXXXXXXXXXXXXXXXXXXXXXXXXXXXXXXXXXXXXX	1	{ (I272, 1) }
IIOOOIIOIIOOOIIOIIIIIIIOOOIOOOOIOIOOIOIIIIOIIIOIOOIOII	XXXXDXXXXXXXXXXXXXXXXXXXXXXXXXXXXXXXXXXXXX	1	{ (G312, 0) }
IIOIOIIOIIOOOIIOIIIIIIIOOOIOOOOIOIOOIOIIIIOIIIOIOOIOII	XXXXBXXXXXXXXXXXXXXXXXXXXXXXXXXXXXXXXXXXXX	1	{ (G312, 1) }
IIOOOIIOIIOOOIIOIIIIIIIOOOIOOOOIOIOOIOIIIIOIIIOIOOIOII	XXXXDXXXXXXXXXXXXXXXXXXXXXXXXXXXXXXXXXXXXX	1	{ (G313, 0) }
IIOIOIIOIIOOOIIOIIIIIIIOOOIOOOOIOIOOIOIIIIOIIIOIOOIOII	XXXXBXXXXXXXXXXXXXXXXXXXXXXXXXXXXXXXXXXXXX	1	{ (G313, 1) }
IIOIOIIOIIOOOIIOIIIIIIIOOOIOOOOIOIOOIOIIIIOIIIOIOOOIII	XXXXXBXXXXXXXXXXXXXXXXXXXXXXXXXXXXXXXXXXXX	1	{ (I275, 0) }
OOIOOIIIIIOIOOOOOIOIOIOOIOIIIOOIOOIIOIOOOOOIOOIOIOOIII	XXXXXDXXXXXXXXXXXXXXXXXXXXXXXXXXXXXXXXXXXX	1	{ (I275, 1) }
OOIOOIIIIIOIOOOOOIOIOIOOIOIIIOOIOOIIOIOOOOOIOOIOIOOIII	XXXXXDXXXXXXXXXXXXXXXXXXXXXXXXXXXXXXXXXXXX	1	{ (G315, 0) }
OOIIOIIIIIOIOOOOOIOIOIOOIOIIIOOIOOIIOIOOOOOIOOIOIOOIII	XXXXXBXXXXXXXXXXXXXXXXXXXXXXXXXXXXXXXXXXXX	1	{ (G315, 1) }
OOIOOIIIIIOIOOOOOIOIOIOOIOIIIOOIOOIIOIOOOOOIOOIOIOOIII	XXXXXDXXXXXXXXXXXXXXXXXXXXXXXXXXXXXXXXXXXX	1	{ (G316, 0) }
OOIIOIIIIIOIOOOOOIOIOIOOIOIIIOOIOOIIOIOOOOOIOOIOIOOIII	XXXXXBXXXXXXXXXXXXXXXXXXXXXXXXXXXXXXXXXXXX	1	{ (G316, 1) }
OOIIOIIIIIOIOOOOOOIIOIOOIOIIIOOIOOIIOIOOOOOIOOIOIOOIII	XXXXXXBXXXXXXXXXXXXXXXXXXXXXXXXXXXXXXXXXXX	1	{ (I278, 0) }
OOIOOIIIIIOIOOOOOOIIOIOOIOIIIOOIOOIIOIOOOOOIOOIOIOOIII	XXXXXXDXXXXXXXXXXXXXXXXXXXXXXXXXXXXXXXXXXX	1	{ (I278, 1) }
OOIOOIIIIIOIOOOOOOIIOIOOIOIIIOOIOOIIOIOOOOOIOOIOIOOIII	XXXXXXDXXXXXXXXXXXXXXXXXXXXXXXXXXXXXXXXXXX	1	{ (G318, 0) }
OOIIOIIIIIOIOOOOOOIIOIOOIOIIIOOIOOIIOIOOOOOIOOIOIOOIII	XXXXXXBXXXXXXXXXXXXXXXXXXXXXXXXXXXXXXXXXXX	1	{ (G318, 1) }
OOIOOIIIIIOIOOOOOOIIOIOOIOIIIOOIOOIIOIOOOOOIOOIOIOOIII	XXXXXXDXXXXXXXXXXXXXXXXXXXXXXXXXXXXXXXXXXX	1	{ (G319, 0) }
OOIIOIIIIIOIOOOOOOIIOIOOIOIIIOOIOOIIOIOOOOOIOOIOIOOIII	XXXXXXBXXXXXXXXXXXXXXXXXXXXXXXXXXXXXXXXXXX	1	{ (G319, 1) }
OOIIOIIIIIOIOOOOOOIIOIOOIOIIIOOIOOIIOIOOOOOIOOIOIOOIII	XXXXXXXBXXXXXXXXXXXXXXXXXXXXXXXXXXXXXXXXXX	1	{ (I281, 0) }
IIIOOOOOIOOOOIIOIIOIIIOOOOOIOIIIOOOIOOIOIOOIOOOOIIOOOI	XXXXXXXDXXXXXXXXXXXXXXXXXXXXXXXXXXXXXXXXXX	1	{ (I281, 1) }
IIIOOOOOIOOOOIIOIIOIIIOOOOOIOIIIOOOIOOIOIOOIOOOOIIOOOI	XXXXXXXDXXXXXXXXXXXXXXXXXXXXXXXXXXXXXXXXXX	1	{ (G321, 0) }
IIIIOOOOIOOOOIIOIIOIIIOOOOOIOIIIOOOIOOIOIOOIOOOOIIOOOI	XXXXXXXBXXXXXXXXXXXXXXXXXXXXXXXXXXXXXXXXXX	1	{ (G321, 1) }
IIIOOOOOIOOOOIIOIIOIIIOOOOOIOIIIOOOIOOIOIOOIOOOOIIOOOI	XXXXXXXDXXXXXXXXXXXXXXXXXXXXXXXXXXXXXXXXXX	1	{ (G322, 0) }
IIIIOOOOIOOOOIIOIIOIIIOOOOOIOIIIOOOIOOIOIOOIOOOOIIOOOI	XXXXXXXBXXXXXXXXXXXXXXXXXXXXXXXXXXXXXXXXXX	1	{ (G322, 1) }
IIIOOOOIOIIIOOOIIOIIOIIOOOIOOIOIIIOOOIOOIOIOOIOOOOIIOO	XXXXXXXXXXXXXXDXXXXXXXXXXXXXXXXXXXXXXXXXXX	1	{ (G143, 0) }
IIIOOOOIOOIIOOOIIOIIOIIOOOIOOIOIIIOOOIOOIOIOOIOOOOIIOO	XXXXXXXXXXXXXXBXXXXXXXXXXXXXXXXXXXXXXXXXXX	1	{ (G143, 1) }
IIIOOOOIOOIIOOOIIOIIOIIOOOIOOIOIIIOOOIOOIOIOOIOOOOIIOO	XXXXXXXXXXXXXXBXXXXXXXXXXXXXXXXXXXXXXXXXXX	1	{ (I303, 0) }
IIIOOOOIOIIIOOOIIOIIOIIOOOIOOIOIIIOOOIOOIOIOOIOOOOIIOO	XXXXXXXXXXXXXXDXXXXXXXXXXXXXXXXXXXXXXXXXXX	1	{ (I303, 1) }
IIIOOOOIOIIIOOOIIOIIOIIOOOIOOIOIIIOOOIOOIOIOOIOOOOIIOO	XXXXXXXXXXXXXXDXXXXXXXXXXXXXXXXXXXXXXXXXXX	1	{ (G350, 0) }
IIIOOOOIOOIIOOOIIOIIOIIOOOIOOIOIIIOOOIOOIOIOOIOOOOIIOO	XXXXXXXXXXXXXXBXXXXXXXXXXXXXXXXXXXXXXXXXXX	1	{ (G350, 1) }
IOIIOIIIIOIIOIOOIOOIIIOOIOOIIOOIOOIIOOIIOOOIIIOIIOOIII	XXXXXXXXXBXXXXXXXXXXXXXXXXXXXXXXXXXXXXXXXX	1	{ (I299, 0) }
IOOIOIIIIOIIOIOOIOOIIIOOIOOIIOOIOOIIOOIIOOOIIIOIIOOIII	XXXXXXXXXDXXXXXXXXXXXXXXXXXXXXXXXXXXXXXXXX	1	{ (I299, 1) }
IOOIOIIIIOIIOIOOIOOIIIOOIOOIIOOIOOIIOOIIOOOIIIOIIOOIII	XXXXXXXXXDXXXXXXXXXXXXXXXXXXXXXXXXXXXXXXXX	1	{ (G281, 0) }
IOIIOIIIIOIIOIOOIOOIIIOOIOOIIOOIOOIIOOIIOOOIIIOIIOOIII	XXXXXXXXXBXXXXXXXXXXXXXXXXXXXXXXXXXXXXXXXX	1	{ (G281, 1) }
IOIIOIIOIOIIOIOOIOOIIOOIIOOIIOOIOOIIOIOIOOOIIIOIIOOIII	XXXXXXXXXXXBXXXXXXXXXXXXXXXXXXXXXXXXXXXXXX	1	{ (I313, 0) }
IOOIOIIOIOIIOIOOIOOIIOOIIOOIIOOIOOIIOIOIOOOIIIOIIOOIII	XXXXXXXXXXXDXXXXXXXXXXXXXXXXXXXXXXXXXXXXXX	1	{ (I313, 1) }
IOOIOIIOIOIIOIOOIOOIIOOIIOOIIOOIOOIIOIOIOOOIIIOIIOOIII	XXXXXXXXXXXDXXXXXXXXXXXXXXXXXXXXXXXXXXXXXX	1	{ (G283, 0) }
IOIIOIIOIOIIOIOOIOOIIOOIIOOIIOOIOOIIOIOIOOOIIIOIIOOIII	XXXXXXXXXXXBXXXXXXXXXXXXXXXXXXXXXXXXXXXXXX	1	{ (G283, 1) }
IOIOOIIIIIOIOOIOOIIOOIOOIIOOIOOIIIOIIOOOIIIIOIIOOIIIOI	XXXXXXXXXXXXXXXXXXXXXBXXXXXXXXXXXXXXXXXXXX	1	{ (G100, 0) }
IOIIOIIIIIOIOOIOOIIOOIOOIIOOIOOIIIOIIOOOIIIIOIIOOIIIOI	XXXXXXXXXXXXXXXXXXXXXDXXXXXXXXXXXXXXXXXXXX	1	{ (G100, 1) }
IOIOOIIIIIOIOOIOOIIOOIOOIIOOIOOIIIOIIOOOIIIIOIIOOIIIOI	XXXXXXXXXXXXXXXXXXXBXXXXXXXXXXXXXXXXXXXXXX	1	{ (G98, 0) }
IOIIOIIIIIOIOOIOOIIOOIOOIIOOIOOIIIOIIOOOIIIIOIIOOIIIOI	XXXXXXXXXXXXXXXXXXXDXXXXXXXXXXXXXXXXXXXXXX	1	{ (G98, 1) }
OIIOOOIIIOOOOIOIIOOIIOOIIOIOOIOOOIIIIIOOIOOIIIOOOIOOOO	XXXXXXXXXXXXXXXXXBXXXXXXXXXXXXXXXXXXXXXXXX	1	{ (G96, 0) }
OIIIOOIIIOOOOIOIIOOIIOOIIOIOOIOOOIIIIIOOIOOIIIOOOIOOOO	XXXXXXXXXXXXXXXXXDXXXXXXXXXXXXXXXXXXXXXXXX	1	{ (G96, 1) }
OIOIOOIIIOIOOOOIOIIOOIIIOOIIOIOOOOOIOIIIIOOIOOIIOOOIOO	XXXXXXXXXDXXXXXXXXXXXXXXXXXXXXXXXXXXXXXXXX	1	{ (I301, 0) }
OIIIOOIIIOIOOOOIOIIOOIIIOOIIOIOOOOOIOIIIIOOIOOIIOOOIOO	XXXXXXXXXBXXXXXXXXXXXXXXXXXXXXXXXXXXXXXXXX	1	{ (I301, 1) }
OIOIOOIOIOIOOOOIOIIOOIIIOOIIOIOOOOOIIIOIIOOIOOIIOOOIOO	XXXXXXXXXXXDXXXXXXXXXXXXXXXXXXXXXXXXXXXXXX	1	{ (I315, 0) }
OIIIOOIOIOIOOOOIOIIOOIIIOOIIOIOOOOOIIIOIIOOIOOIIOOOIOO	XXXXXXXXXXXBXXXXXXXXXXXXXXXXXXXXXXXXXXXXXX	1	{ (I315, 1) }
OIIIIOOOIOIIOOOOIOIIOOIIIOOIIOIOOOOOIIIIIOOIOOIIOOOIOO	XXXXXXXXXXBXXXXXXXXXXXXXXXXXXXXXXXXXXXXXXX	1	{ (I306, 0) }
OIOIIOOOIOIIOOOOIOIIOOIIIOOIIOIOOOOOIIIIIOOIOOIIOOOIOO	XXXXXXXXXXDXXXXXXXXXXXXXXXXXXXXXXXXXXXXXXX	1	{ (I306, 1) }
OIOIIOOOIOIIOOOOIOIIOOIIIOOIIOIOOOOOIIIIIOOIOOIIOOOIOO	XXXXXXXXXXDXXXXXXXXXXXXXXXXXXXXXXXXXXXXXXX	1	{ (G282, 0) }
OIIIIOOOIOIIOOOOIOIIOOIIIOOIIOIOOOOOIIIIIOOIOOIIOOOIOO	XXXXXXXXXXBXXXXXXXXXXXXXXXXXXXXXXXXXXXXXXX	1	{ (G282, 1) }
OIOOOIIOIOIIIOOIIOIOIIIOOIIIIIIIIOIOOIOOOIIOIIOOOOIIIO	XXXXXXXXXXDXXXXXXXXXXXXXXXXXXXXXXXXXXXXXXX	1	{ (I308, 0) }
OIIOOIIOIOIIIOOIIOIOIIIOOIIIIIIIIOIOOIOOOIIOIIOOOOIIIO	XXXXXXXXXXBXXXXXXXXXXXXXXXXXXXXXXXXXXXXXXX	1	{ (I308, 1) }
OOOOIIIIIOIIOOIIOIOIIIOOIIIIIIIIOIOOOIOOOIIOIIOOOOIIIO	XXXXXXXXXDXXXXXXXXXXXXXXXXXXXXXXXXXXXXXXXX	1	{ (G232, 0) }
OOIOIIIIIOIIOOIIOIOIIIOOIIIIIIIIOIOOOIOOOIIOIIOOOOIIIO	XXXXXXXXXBXXXXXXXXXXXXXXXXXXXXXXXXXXXXXXXX	1	{ (G232, 1) }
OIOOOIIOIOIIIOOIIOIOIIIOOIIIIIIIIOIOOIOOOIIOIIOOOOIIIO	XXXXXXXXXXDXXXXXXXXXXXXXXXXXXXXXXXXXXXXXXX	1	{ (G233, 0) }
OIIOOIIOIOIIIOOIIOIOIIIOOIIIIIIIIOIOOIOOOIIOIIOOOOIIIO	XXXXXXXXXXBXXXXXXXXXXXXXXXXXXXXXXXXXXXXXXX	1	{ (G233, 1) }
OOOOIIIOIOIIOOIIOIOIIOOIIIIIIIIIOIOOIOOOOIIOIIOOOOIIIO	XXXXXXXXXXXDXXXXXXXXXXXXXXXXXXXXXXXXXXXXXX	1	{ (G234, 0) }
OOIOIIIOIOIIOOIIOIOIIOOIIIIIIIIIOIOOIOOOOIIOIIOOOOIIIO	XXXXXXXXXXXBXXXXXXXXXXXXXXXXXXXXXXXXXXXXXX	1	{ (G234, 1) }
OOOOIIIOIIIOIIOOIIOIOIIIOOIIIIIIIIOIOOOIOOOIIOIIOOOOII	XXXXXXXXXDXXXXXXXXXXXXXXXXXXXXXXXXXXXXXXXX	1	{ (G248, 0) }
OOIOIIIOIIIOIIOOIIOIOIIIOOIIIIIIIIOIOOOIOOOIIOIIOOOOII	XXXXXXXXXBXXXXXXXXXXXXXXXXXXXXXXXXXXXXXXXX	1	{ (G248, 1) }
OIOOOIIIOIIOIIIOOIIOIOIIIOOIIIIIIIIOIOOIOOOIIOIIOOOOII	XXXXXXXXXXDXXXXXXXXXXXXXXXXXXXXXXXXXXXXXXX	1	{ (G263, 0) }
OIIOOIIIOIIOIIIOOIIOIOIIIOOIIIIIIIIOIOOIOOOIIOIIOOOOII	XXXXXXXXXXBXXXXXXXXXXXXXXXXXXXXXXXXXXXXXXX	1	{ (G263, 1) }
OOOOIIIIIIIOIIOOIIOIOIIIOOIIIIIIIIOIOOOIOOOIIOIIOOOOII	XXXXXXXXXXXDXXXXXXXXXXXXXXXXXXXXXXXXXXXXXX	1	{ (G264, 0) }
OOIOIIIIIIIOIIOOIIOIOIIIOOIIIIIIIIOIOOOIOOOIIOIIOOOOII	XXXXXXXXXXXBXXXXXXXXXXXXXXXXXXXXXXXXXXXXXX	1	{ (G264, 1) }
OOOIIIIOIIOIOOIIOIOIIOOIIIIIIIIIOIOOIOOOIIOIIOOOOIIIOI	XXXXXXXXXXXXBXXXXXXXXXXXXXXXXXXXXXXXXXXXXX	1	{ (I546, 0) }
OOOIIIIOIIIIOOIIOIOIIOOIIIIIIIIIOIOOIOOOIIOIIOOOOIIIOI	XXXXXXXXXXXXDXXXXXXXXXXXXXXXXXXXXXXXXXXXXX	1	{ (I546, 1) }

Total faults:	894

Detected faults:
	Count:		246
	Percentage:	28%

Undetected faults:
	Total count:	648
	Percentage:		72%
	Output file:	"run/s713_undetected_faults.flt"

Program successfully executed!
